##########
##########
#.  #.####
# $  $####
# #  $.###
#..#.$  ##
# $@ $. ##
# $ *#####
###  #####
##########
