##########
##     ###
## #   $ #
#  * .## #
#  # +$  #
#  $$*$# #
##.# .   #
#   $. ###
# . #    #
##########
