##########
###     ##
#.  $ $  #
##  #*#  #
#   *+* ##
##  #*#  #
##  $ $  #
###     ##
####.#.###
##########
