########
#    #@#
# #  $ #
# .$ . #
# #$ $##
#   $. #
# .  # #
#  #.  #
########
