##########
##       #
##.#$# #.#
# $+$ $ $#
#  $$ .$ #
#.# # #..#
#   .    #
##########
