########
# #   ##
# .$.$ #
# $@$  #
# .$. .#
#     ##
########
########
