#########
#.  $  .#
#  .$.$ #
# #$@$# #
# *.$.  #
#  # # ##
## $ . ##
#########
