##########            
#  #     #            
#  #   $ #            
#######$ #            
#..... $@#            
#######$ #            
#  #   $ #            
#  #     #            
##########            
                      
                      
                      
                      
