############          
#..  #     ###        
#..  #    $  #        
#..  #$####  #        
#..    @ ##  #        
###### #  $ ##        
###### ##$ $ #        
  # $  $   $ #        
  #    #     #        
  ############        
                      
                      
                      
