######  ###           
##.  # ##@##          
#..  ###   #          
#..     $$ #          
#..  # # $ #          
##.### # $ #          
####   #$  #          
   #  $# $ #          
   #    $  #          
   #  ##   #          
   #########          
                      
                      
