##########            
#     $.#            
# $    .#            
#  $   .#            
# $@$  .#            
#  $   .#            
# $    .#            
#      .#            
##########            
                      
                      
                      
                      
