##########            
#     $. #            
#     $. #            
#     $. #            
#  @  $. #            
#     $. #            
#     $. #            
#     $. #            
##########            
                      
                      
                      
                      
