####################  
                     
  ################### 
                    # 
  ###############  # 
                    # 
##*##############  # 
                  # # 
  ## # # # # # #   # 
# ################### 
#                   # 
#  ###############$ # 
###@               ##.
