##########            
#        #            
#        #            
#        #            
#  @  $. #            
#        #            
#        #            
#        #            
##########            