########              
#      #              
# $$   #              
# $ $  #              
#  $ $@#              
#......#              
########              
                      
                      
                      
                      
                      
                      
