  ####
### .##
#.    ####
####*   @#
#### $ $ #
#.## #####
#   . $ ##
#$$      #
#. ###   #
#### #####
