 ######
 #.*..#
 ##.$*#
## .*@#
# $  ###
#  $$$ #
#      #
########
