##########
#..      #
#  ####. #
#   ##   #
###$$@$ ##
  #.$ #. #
  # #$#  #
  #      #
  ########
