        ####
    #####  #
    #   # .#
    # $ .  ##
    #  #$#  ##
    ##@ $    #
     #.###.  #
######  *  ..#
#   #  .###  #
#   $$$ # ####
# #   $##
#####  #
    #  #
    ####
