      ####
      #. #
#######..#
# $  $   #
#  #    $#
#   ##$  #
###@ $  ##
  #   #$ #
 #### #  #
 #..  .  #
 #########
