###########
# ....##  #
#  $.$    #
####  $   #
   ###  ###
     ##$$@#
      #   #
      #####
