   #######
  ##..* .#
###. $   #
# .$ #  ###
# ## ## $ #
#   .#  $@#
##    $ $ #
 ###  .#$ #
   ###   ##
     #####
