      ###
#######.##
#+.      #
#  ####. #
#   ## $ #
### $   ##
  # $ #  #
  # #$#  #
  #   .$ #
  ########
