       ####
       #..#
    ####..#
    #.  $ #
    ##.#  #
 #####$   #
 #@$.    ##
##$  $$ ##
#  $ #  #
#   #####
#####
