      #####
    ###  .#
    #    ##
    #.$   #
 #### $   #
 #.##*#####
 #     $ ##
##  @ $   #
#.  ###   #
##### #####
