 ######
 #.. @#
 ###$ #
  #  ##
###$ .#
#. $  #
# #$ ##
#   $ #
###   #
  #. ##
  ####
