  #####
  #...##
  #..*.#
  # $$ #
### $ $#
# $    ##
#  ## $ #
# ###   #
#  @##  #
#########
