       ##########
       #      ###
       # ###$ ###
       #@     ###
    #### # # $  #
    #    # # #$ #
    # ## # # $  #
#####      #    #
#     # ####  $ #
# # # # ####$$# #
# #     ####  $ #
# # ## #####    #
#       #########
## ### ###..#.###
 #            ###
 ########     .##
        # ##  .##
        #. . .###
        #########
