     ####
   ###  ##
####     #
# ..    $#
#   ###. #
#####   $#####
#####$     $+#
#    $ #$ ####
#    #. .##
##     ###
 #######
