      ####
#######. #
#@$  $ $ #
#  #   . #
#   ##   #
###$ $  ##
  #   #* #
  #.# #  #
  #   . .#
  ########
