     ###
###  #.###
#.#  #.$ #
# ####*..#
# .   $ .#
# $##$ $ #
## @  $# #
 ### #  $#
   #     #
   #######
