    #####
    #   #
    # $ #########
    # $ ##     ##
#####  ### ### ##
#  $  ####  #   #
#    $          #
# $ # # ##....# #
### # # ##....# #
  # # # ####### #
  # #       $ #$##
  #   ######$    #
  #####    #  @  #
           #######
