###
#.########
#. #    .#
# .     ##
# ##.   #
#   $  ##
##  $ $###
 ####$$  #
 #.    $@#
 #########
