        ####
        #  #
        #  #
     #### $#
   ###  ## #
#### $   # ####
# ..   .   .  #
#   ###$$#$## #
####  $ .# *  #
   # #  ##.  @#
   # . $   ####
   #  ######
   ####
