       ####
      ## +#
 ###### . #
 #   ##.  #
 #     $  #
 ##*$ $ $ #
 #  #######
##   #
#.   #
######
