##########
#...  .  #
#  #     #
# $  ##  #
#$$$#  ###
#@$  . #
########
