        ###
      ###.#
      #.#.#
     ## #.#
######  . #
#. $  $ $ #
##$ #   ###
 #.$ #$$  #
 #+$      #
 ##########
