       ####
      ##..#
 ######   #
 #   ##.$ #
 #    $   #
 # $ #  # #
#### #   $#
#  $*#.. @#
#        ##
##########
