      #####
 ######.$ #
 #@$      #
 #####$   #
##. ## #  #
#. $   $ ##
##   .#  #
 ####.####
    ###
