   ###
   #.##
   #  ####
   #*    #
   # $@$ #
#### #####
#.  .   ##
# $    $ #
#. ###   #
#### #####
