   ######
####    #
#.# ... #
# #. #.###
#        #
# $ #    #
###  #####
#     #
#     ###
####    #
  ##$$#$##
  #    $ #
  #  $## #
  ###    #
    ###@ #
      ####
