         #######
     #####..  .#
    ##   #  # @#
    # $$ ##    #
#####$    $  #.#
# $    # ##  ..#
#. $ # $ ###  ##
##     ### ####
 #######
