    #######
#####.    #
#   #  #$$#
#   ##  $ #
#  .  $.# #
# #  #  $+#
#.  ###  ##
###      #
  ########
