###################
####        ##   ##
#### $  $ $ ## # ##
###### $##  #  #  #
##       #$ # ### #
#   ##   #     #  #
# #$##$######### ##
# $ ## ##         #
#   #  ##   ### # #
### #  ###      # #
### ## ### #### # #
###        #### # #
##########      # #
############### # #
########    ### # #
#...      # ### # #
#...      # ### # #
###.# #####       #
###.          #####
####  ##@     #####
###################
