      #####
##### #   #
#  @###$  #
#.$  ##   #
#   .#  $ #
####..$$ ##
  ##. $  #
  #.  #* #
  #     ##
  #######
