#########
#. *  $ #
#...#   #
#$$    ##
#  # $ #
#  # @##
#######
