  ####
  #  #
###  ##
#@$ $ #
# $   #
##.## #
#..*  #
# . $ #
#######
