  ######
 ##    #
 # $ # #
## * # #
#  ..$.#
# . $$ #
#### @##
   ####
