#####
#  @###
#  $  #
# $$  #
### $ #
#...$##
##.  #
 #. ##
 ####
