
    ####
### #  #
#.###$ #
# $  $ #
# ..$ .#
#  #+$ #
####  ##
   ####
