#######
#  #@ ####
#  $$$   #
#     .$ #
#  ### *##
#### # ..#
     ##. #
      ####
