  #####
###   #
#     #
# $$###
## . #
 #$. ##
 # .$ #
 # *# #
 ##. @#
  #####
