 ####
##  ####
#. . $@#
#$.#$###
# $  $ #
# ..   #
#    ###
######
