#######
#.    #
# $$  #
#...$##
# $* #
##@ ##
 ####
