#####
#   #
#.# #
#.  ###
#.# $ #
#.*$  #
#  $  #
###@$##
  #  #
  ####
