#######
#.    ###
## ##$ .#
#     $ #
#   ##$ #
###### .#
#     $*#
#   ##@.#
#########
