 #######
 # $ + #
## .*. ##
#  $#*$ #
#       #
##  #####
 ####
