 ########
 #.  #  #
 #.# #  #
## .  $ #
#  $$ $*#
# . ## @#
#########
