#####
#@  #
# $$##
## . ##
#  ** #
#   $ #
### ..#
  #   #
  #####
