####
#  ###
#    ##
# $$$@#
##  #$#
 # .*.#
 # .#.#
 #  ###
 ####
