   #####
   #   #
####$# ###
# $      #
#..*# *  #
#. @$  ###
#  #  ##
#######
