     ####
     #  #
###### .#
#.#@ #$.#
#  $$$..#
# $     #
#  #  ###
#######
