#########
#  @#   #
#.**..  #
#   ## ##
# $$$  #
###    #
  ######
