    ###
#####@#
#  # $####
# $      #
# ### $  #
#  # $ ###
#. .$  #
#...#  #
########
