 ####
 # @#####
##$$    #
#  $*.. #
#   #$. #
#  ## . #
#########
