#######
# ..  #
# #$$ #
#  $ .#
# . *$#
#  # @#
#######
