    #####
     #   #
 ##### $ #
## $     #
#  *$ $ ##
#..@##  #
#..######
####
