#######
# .   ##
# .$$* #
##   $@#
# * ####
#      #
#.##   #
########
