 ####
 #  ####
##$... #
#  #  $###
# $## $. #
#       @#
##  $.####
 ######
