#######
# $  .#
#+*$# #
##    #
#  $* #
#   .##
######
