##########
#.    .  #
# $#$#$# #
## . #   #
### $ . ##
#@$.   ##
########
