     #####
######   #
# $   $  #
#  ..*# ##
#  #*. $ #
#  #@    #
##########
