 ####
 #  ###
 #  $@#
 # *..#
##$.#.#
# $ $ #
#    ##
#  ###
####
