 #####
## @ ##
#.$*$ #
#   $.#
##$.  #
 #  . #
 ######
