#######
#  #  #
#  # .##
#  $$  #
##$* * #
#  @# ##
# ..  #
#######
