  #####
###   #
# $   #
# @$ ##
# $$####
## . $ #
 # ....#
 #######
