######
#    ###
# .#$  #
#  $   #
##.#$ ##
## #@##
# .$$#
#    #
#..  #
######
