  #####
  # . #
 ##$*@#
 # ..$##
## #.  #
#   $$ #
#     ##
#######
