   ####
  ##@ ##
### *$.##
#  $ $. #
#  .#   #
# *     #
#########
