#####
# . #
#$*@###
# $$  #
#..$  #
#   . #
#######
