#######
# .$ .#
#   $##
#  $  #
#$#$# #
#. @..#
#######
