     ####
     #@ #
  ####$*#
###   $ #
# $   $ #
#    ## #
#.# ... #
#########
