#######
#.  $.#
# $   #
# #   #
#$ $#$#
#+.  .#
#######
