######
#.#. ###
#.#    #
#  . # #
#  #$  #
##   $##
 ##$  #
##@$$##
#.   #
######
