 #####
##   #
# .$.#
#   .###
###$ $ ##
#   $$. #
#   # .@#
#########
