########
#    * #
# #$#  #
#+$   ###
##$. .  #
 #  *   #
 ########
