#######
#  . .#
#  $$ #
###$  #
#   *$#
# .@. #
#######
