#########
#  ##   #
#   $   #
#  #### #
# $## . #
#.$ ... #
# $$## ##
###    @#
  #######
