########
#.  #  #
# #$   #
#.$@*#.#
# #$$  #
# #   ##
#   .##
######
