####
#  ##
#   #####
#  $  $ #
##  **+.#
 #  . $ #
 ########
