 ####
 #  ####
 #   $ #
##  #$ #
# $ #@.#
#  $ *.#
#  ##..#
########
