     ####
     # @#
######$$#
#     $ #
# ..$$ .#
#..##   #
#########
