"######  ###           
#..  # ##@##          
#..  ###   #          
#..     $$ #          
#..  # # $ #          
#..### # $ #          
#### $ #$  #          
   #  $# $ #          
   # $  $  #          
   #  ##   #          
   #########          
                      
                      
"