
####           ####
#   ###########   #
# #  #  . .  #  # #
#  #  #  .  #  #  #
#  ##  #   #  ##  #
#  # #  # #  # #  #
#  #  #  $  #  #  #
#  $ . ## ## $ .  #
#  . $ ## ## . $  #
#  #  #  .  #  #  #
#  # #  # #  # #  #
#  ##  # $ #  ##  #
#  #  # $@$ #  #  #
# #  #       #  # #
#   ###########   #
####           ####

