
#####  ####
#   ####  #
#      $$ #
##$#####  #
#  #.. $ ##
#  ...##  #
#  #.. #$@#
####   #  #
  ##$#### ##
  #    $   #
  #   ##   #
  ##########

