
  ####
 #    #    ###
 #  $  ####   #
  #$#  .    $ #
  #   #.###$##
   ## #+.   #
  #   ..# ##
 ##$###.#   #
# $    .  #$#
#   ####  $  #
 ###    #    #
         ####

