
  ####
  #  #
  #  #####
  # .    #
###$***  #
#  *..$ ##
#@ $ .$##
####   #
   ##  #
    ####

