
#####
#   ######
# #$##   #
#    $   #
###$ ##$##
  # ... #
  #$ .#$#
 ## ... #
 # $#.#$#
 #   @  #
 #  #  ##
 #######

