
 #########
 #   ##  #
 #    $  #
 ## #*#$ #
 #  *.# ##
##$#@*. ###
#  .*.#   #
# $ #   # #
#    ##   #
##   ######
 #####

