
  #########
 ##   #   #
## $# # #$###
#   #. .#   #
# $ *.@.* $ #
#   #. .#   #
###$# # #$ ##
  #   #   ##
  #########

