
###############
#   #  .  #   #
# #@# * *$# # #
#  $  . *     #
##### * *$#####
    #  .  #
    #######

