
    ########
 ####   #  #
 #  #.#.   #
 #   ***#  #
 #  #...  ##
### ##$## ##
#  $# $    ##
#  $ @##    #
## $#####   #
 #  #   #####
 ####

