
  #####
  #   #
  # @ #
 ###*###
  #   #
 #     #
 #  $  #
  #   #
  ##*##
 #     #
 #* . *#
#   #   #
# .$#$. #
#   *   #
 #######

