
########
# $  . #
#+##* .#
# $  . #
#  $ # #
# #$$# #
#.$  . #
########

