
###############
#    #  #     #
# $$...$*..$$@#
#  ## # ####  #
#      *      #
###############

