
 #####
##   #
#  # ##
# # $ #
# # * #
# # * ##
# # *  #
# # +# #
#  #   #
##   ###
 #####

