
#####
#   #####
# #     #
#  *### ##
##*   #  #
# * $.## ##
# ##.$ *  #
# @#   *# #
## ###*   #
 #     # ##
 #### #  #
    #   ##
    #####

