
########
#+$   .#
#$#  #$#
#  $ $ #
# .#$# #
#  . . #
#.   $.#
########

