
##########
#   ##   #
# # ## # #
#.     # #
#.##$#$# #
#.#  $@$ #
#.#   #  #
#.# $$   #
#.#  #   #
##########

