
  #######
 ##     ##
## $# #$ ##
# $  *  $ #
#   #*#   #
## #.*.# ##
 #  .*.  #
 ### # ###
   # @ #
   #####

