
######
#    #
#    #
##$ ###
# $   #
#.***.#
#  @  #
#######

