
      #
##########
###   #  #
# @..*.$ #
# $ $ #  #
##### # ###
    # #  #
    #    #
    ###  #
    ######

