
 ####
 #  ######
 #     $@#
## ##*##$#
#  # . # ##
#  $...   #
## # . #  #
#  ##*##$##
#  $      #
#  #  #   #
###########

