
   ########
####  #   #
#  #      #
# $   ##$##
#  ## ## ###
## .**##   #
 #  *+*  # #
 ## ####   #
  #      ###
  ########

