
 ####
 #  ######
## **    #
#   ## # #
# $ @**. #
#   ## # #
## **    #
 #  ######
 ####

