
 #####
###  #
## * ###
#  $  ##
#@#$# ##
# .$. .#
###    #
  #  ###
  #####

