
##########
#+ #     #
# $      #
# # #* # #
# # #  # #
# #****# #
#   #    #
##########

