
#########
#   *   #
# $ + $ #
# ##.## #
#   *   #
#########

