
###########
#    .  $ #
#  $ *$ $@#
#####.#####
#  $ .  . #
# .  .  $ #
###########

