
####
#  #####
#  . ###
#  * ###
## *   #
 # *$@ #
 #  ####
 #######

