
  #####
 #  #  #
 #* @ *#
#   #   #
# .$#$. #
#   *   #
 #######

