
  ####
  #  #
  #. #
  # $#
  #. #
### $###
#  .$  ##
# # $$  #
# .##. @#
## *  $##
 #  .  #
 #######

