
##########
#   ###  #
#@$$$... ##
### ###   #
  #       #
  #########

