
     ###
    #   #
    # # #
    # $ #
 ####.#.####
#   . $ .   #
# #$#$#$#$# #
#   . @ .   #
 ###########

