
    #####
    #   ##
  ### #  #
###    # ##
#   # ** .#
# #***  # #
#  * *  # #
#  $ ###  #
####@    ##
   #######

