
 #####
 #   ####
 #$ $+$ #
 #.#.#  #
## # #  #
#  *$. ##
#  .$ $ #
# $. .  #
#########

