
  #####
  # @ ##
###$$$ ###
#  .# .  #
# #.# .# #
#  . #.# #
# *$$$   #
###  # ###
  ##   #
   #####

