
########
#  .   #
# $#$$ #
#  ..$ #
###.$###
#  .$ #
#  +  #
#######

