
#########
#   *   #
#  *+*  #
## # # ##
#   $   #
#   #   #
#########

