
#########
#   #   #
#+#$* * #
# $ ..# #
#  $#   #
# *     #
#########

