
  ####
  #  #
###  #
#    #####
#  * #   ###
### *#  *$ #
 ## *  **@ #
 #  #   *.##
 #  ####  #
 #  #  ####
 ####

