
     ####
    #    #
  ##.# #  #
 #  $ $.# #
#  # # #  #
# #.$ $@# #
#  # #.#  #
 #   ##  #
  #     #
  #  ###
   ##

