
 #######
##     #
#  .*.$##
#  *#*$@#
##$*..$ #
 #    ###
 ######

