
#######
##    #
##.$. #
# $.$##
# .$.##
# $.$ #
##   @#
####  #
#######

