
       #####
     ###   #
######  *  #
#    * # # #
#+* * * *$ #
#  # ###   #
# *  # #####
#  ###
####

