
########
#  ....#
# $$ $ #
# @$####
#   #
#####

