
#####
#   #
#   ###
## $  #
#+**# #
#     #
#######

