
   ###
   #+#
####.####
#  ***  #
#  $ $  #
##  *  ##
 #  *  #
 #######

