
  ####
  #  ##
  #   #
  # * #
  #*@*#
  # * ##
### *  #
#  *$  #
# .   ##
#######

