
  ####
  #  #
###  #
#.*  ##
##**  #
 #@*$ #
 #   ##
 #####

