
#######
#  #  #
# @#  #
# $*  ##
# * *  #
####.  #
   #  ##
   ####

