
 ####
 #  ##
 #$. #
 #.$ ####
## .$.@ #
#  $.$  #
# $. ####
# .$ #
######

