
  #####
 ##   ##
##  *  ##
#  *$*  #
# #. .#@#
#  *$*  #
##  *  ##
 ##   ##
  #####

