
 ####
 #  ######
 #   $@$ #
## ##*## #
#  # . # #
#   ..*# ##
## # *    #
 #$##.#   #
 #     $ ##
 ###  ####
   ####

