
########
#  #   #
# $ @#$#
#  #   #
## . .$#
## ##. ##
#  ##.  #
# $.$.$ #
#  ######
####

