
  ######
###  . ###
# $.$$$  #
# # #. # #
# @. . # #
#### $   #
   #$.####
   #  #
   ####

