
  #####
### + ###
# $ $ $ #
# #***# #
# .   . #
##     ##
 #######

