
  ###
###+###
#.$$ .#
#   #$#
#   * #
#$$#  #
# . . #
#.$ $.#
#######

