
######
#    #
# ##.###
# $.   #
# ##$  #
#$$  # #
#. + $.#
########

