
    #####
   ##   ###
  ##      #
 ## $#$$# ##
## $  $  $ #
#  # #$# # #
#  ...@....#
#  #########
####

