
##################
#   #         .  #
#   ###########  #
#     .    .  #  #
##.# ######## # ##
 #.# #      # # #
 # # # $$ $ # # #
## # #  ##$ # # #
#  # #  ##  # # #
#  # # $$ $ # # #
#  # #  $   # # #
#  # #### ### # #
#  #          # ###
#  #   #  # ..    #
# @#   #  #   #.  #
###################

