
##########
###  $+  #
#    $.  #
# *****  #
##      ##
##########

