
#########
#   .   #
# ##$## #
# #   # #
#.$ . $.#
# # $ # #
# #*$## #
#   +   #
#########

