
 ####
 # @######
 #$$   $ #
 # $# ## #
 #  #   .#
##$   ##.#
#  # $*..#
#      ..#
##  ######
 ####

