
#############
#     .     #
# $ # # # $ #
# ### # ### #
# $ $ # $ $ #
#..  *+*  ..#
#############

