
  ######
  #  . ##
  # #*  #
  # $.$ #
  ## *. #
 ## $.@ #
## # .$ #
#  $$.# #
#      ##
########

