
   #####
####   ##
#   *   #
#+***$# #
#   *   #
#####   #
    #####

