
###########
#  #   #  #
#@   $    #
#  ##*##  #
## ##.## ##
#   #... ##
# #$##.#  #
#  $   $$ #
#####  #  #
    #######

