
   ####
#### @#
#  $$ ##
# #$.  #
#  ..# #
####   #
   #####

