
#####
#.@.#
#*#*###
# $ $ #
#     #
#    ##
######

