
  #####
 ##   ##
##  .  ##
# $#$.  #
# . .$. #
# $*$*$ #
##  .  ##
 ## @ ##
  #####

