
##########
###  $+  #
#    $.* #
# *****  #
##       #
##########

