
   #####
####   #
#    # #
#  $@* #
###*#*####
 # * .   #
 # #   * #
 # # ##  #
 #       #
 #########

