
###########
#    .   .#
# #$# #$# #
# .$ @ $. #
# #$# #$# #
#.   .    #
###########

