
####### #####
# *   # #   #
# # # ### # ###
# $ * # * * $ #
# # * . . * # #
# # ## # ## # #
# #    #    # #
# ########### #
#      @      #
###############

