
###########
#   #     #
#  .$ ##  #
# #.$##.. #
# ##   $$##
#  #   #  #
##$$   ## #
# ..##$.# #
#  ## $.  #
#   @ #   #
###########

