
#########
#.  #  +#
# * $$*$#
# . $ . #
#   #   #
#########

