
  #####
  # @ #
 ## # ##
 #  *  #
## # # ##
#  ***  #
# # * # #
#   *   #
#### ####
# $   $ #
# .   . #
#########

