
########
#      #
#  ### #
#.   # #
#.#$$$ #
#.#@ $ #
#.  #  #
########

