
  #####
###   ##
#   #  ###
# *  #   #
#  # $ # #
#@** .#  #
## ##   ##
# * ** ##
# # #   #
#    ## #
####    #
   ######

