
##### ####
#   ### @#
#   $ $ $#
## ##.## ##
 #$.   *  #
 # .   .  #
 ##########

