
   ##### #####
   #   ###   #
   #  * # *  #
####*## # ##*####
#  * $  #  $ *  #
#    .  @  .    #
#################

