
  #####
###   #
# $$# ####
# $@*.   #
# #$...#$##
#   .. $  #
###  ##   #
  #########

