
############
# .$ .  $. #
# #$#  #$# #
# .$.+ .$. #
# #$#  #$# #
#          #
############

