
    ###
  ###.#####
###       #
# $***#*$ #
# *      ##
#   #+####
#######

