
 ######
 #    #
## ## #
#   * #
# *  *#
##$# +#
 # ## #
 #    #
 ######

