
#########
#       #
# ##### ##
#  *   * #
## $ # + #
 ## ### ##
  #     #
  #######

