
########
#. $  ##
#.#  $ #
#..$# @#
# . $$ #
##.$   #
########

