
  ######
  #  ####
  # $ $ ##
### #.#.###
#     #   #
# # #.#.# #
# # $ $ # #
#  #  # # #
##  #   # #
 ##  ###  #
  ##  @  ##
   #######

