
#########
#       #
# ##### #
#..   # #
#.##$ # #
#.#@$ $ #
#.# $ $ #
#.# $ $ #
#.#     #
#########

