
##########
#  .##   ##
#   $@$#  #
##$#.#. $ #
 # #*$*#  #
## #. .  ##
#  .#$# ##
#       #
####   ##
   #####

