
#####
#   ##
# *$ ##
#@ *  ##
# .#$  #
## ...$##
 ### $* #
   #    #
   ######

