
 ####
 #  ###
 # *  #
 # *#@#
## *  #
#  .$##
#    #
######

