
#########
#       #
# ##### #
# #   # #
# # # # #
# *   * #
# *$.$* #
#  #+#  #
##     ##
 #######

