
 #########
 #       #
 #$##.##$##
## #   .  #
#  # .##  #
#  .$  # ##
## ##.## ##
#      $$ #
#   #  #@ #
###########

