
######
#    #
# ##.###
# $.   #
# .#$  #
#$$$ # #
#+ . $.#
########

