
    ####
    #  ###
    #  . #
    #  $ #
    ## ########
 #####  ###   #
 #  ## *      #
##.$# * * #$.##
#      * ##  #
#   ###  #####
######## ##
     # $  #
     # .@ #
     ###  #
       ####

