
##########
#     #  #
# *.*$#$ ##
# . . $   #
# * *$#@  #
#   . #####
#######

