
####
#  ########
# @  .....#
# $####$###
#  ### $  #
# $  # $$ #
#  #.     #
###########

