
#########
#   #   #
# $$# + #
# * * . #
# . * * #
# . #$$ #
#   #   #
#########

