
########
#      #
# #### #
#    # #
#.#$$$ #
#.#@   #
#.  ####
########

