
####
#  ####
#...  #
#.##  ##
#  $ $ #
###$ $ #
  #@   #
  ######

