
#######
#    .#
# #*#+###
# $  *  #
###$# # #
  #  *  #
  # # ###
  #   #
  #####

