
##### ########
#   ###      #
# #  *   **# #
# #  $  #* # #
#  #   #   # #
## ##@#  ##  #
 # ##*# #   ##
 # # *  # ###
 # #   #  #
 #  #.#  ##
 ##  *  ##
  #######

