
#####
#   ##########
# $$#..  #.  #
#    $$$$    #
# $$#...+#.  #
#   ##########
#####

