
 ######
 #    #
 #$@$ #
 # # ##
 # $ ##
 # .  #
##$#$ #
# .$.##
# ...#
######

