
#######
#  #  #
#.$@$ #
#.**  #
#..$$ #
#    ##
######

