
     #####
  ####   #
  #   $  #
###  #$###
#  * .  #
#   * #@#
#####.  #
    #####

