
  #########
 ##   .   ##
##  ##.##  ##
#  #    ##  #
# $.*$@$*.$ #
#  #     #  #
##  ##*##  ##
 ##   *   ##
  #########

