
  #####
### @ ###
# $$$$$ #
# ..... #
#   #   #
#########
    #

