
   #####
#### @ #
# $  # #
#. .$# #
#.# .# #
#  .$# #
##$ $  #
 #  ####
 ####

