
     ##
    #  ##
   #   $ #
   #   # ####
   #  #.     #
  ## #.#$#    #
 #   $   .#   #
 #$#.# @ #.#$#
#   #.   $   #
#   ##$#.# ##
 #     .#  #
  ## # #   #
   #   $   #
    ####  #
        ##

