
 ########
 #      #
##$*### #
#     # #
# #*+ # #
#  *  # #
## ***# #
 #  #   #
 ##   ###
  #####

