
#########
#@#     #
# $...$ #
# $#$#$ #
# $...$ #
# $  .#.#
#########

