
 #######
 #  *  #
 #  @  #
 ##$#.##
 #  #  #
 # $#. #
 #  #  #
## ## ##
#  * * #
#   *  #
###   ##
  #####

