
 #######
##  .  ##
#  . .  #
# . . . #
##$#$#$##
#  $@$  #
# # $ # #
#   #   #
#########

