
  #########
###       #
#   *####$#
#  .$.$ # ##
###  . $+$ ###
  ## #  *$.  #
   # ####.   #
   #       ###
   #########

