
 ####
 #  #
##  ##
#.*  ###
##**   #
 #@**  #
 #  *$##
 #    #
 ######

