
########
#@$  . #
# $#.# #
#  *$  #
# #  #.#
#  $.  #
########

