
####  #####
#  ####   #
#   $     #
#  #$###$##
## .*.*..#
## ## # ##
#     $  #
#   ##@  #
##########

