
######
#   .#
#  $.#
# $#.##
# .*. #
# $$# #
##  $ #
 ##  @#
  #####

