
#########
#   *   #
# $ * $ #
# ##.## #
#  * *  #
## * * ##
 #  +  #
 #######

