
 ###
#   #
# # #
#   #
#+# #
# $  #
#.$# #
 #   #
  ###

