
###############
#   #  @#     #
# *     # $ $ ##
##*###*### #   #
 # .# *     #$ #
 # .#   #   #  #
 # .######### *#
 #             #
 #  ########   #
 ####      #####

