
#####
#+  #######
#*#$$     ###
#.#    ##*  #
#.# # *   # #
# $   #*#   #
# ###   #####
#    *# #
#####   #
    #####

