
    #####
   ##   #
 ###  # ##
 #    *  #
 #   **# #
######.# #
#   #@*  #
# #** $ ##
#  *    #
## # ####
 #   #
 #####

