
  ####
###  #
#    ###
#...$  #
# #  # #
# $$***#
###    #
  # @###
  ####

