
 ########
##  #  ###
##.$#  * ##
#   @ * * #
#   ##    #
######   ##
     #####

