
########
#.$  $.#
#.$  $.#
#+$#   #
#  #   #
########

