
#######
#    @#
#$#$$*#
# $.  ##
# .##  #
# $ #  #
#. .  .#
########

