
 ###########
#   . $  .$ #
# #.#.### # #
#  $*$  # # #
# # # # # # #
#   #   # # #
 ## ##### # #
# $ .  $  * #
# ## ####.# #
#          @#
 ###########

