
  #####
  #   #
### #$#
#  .$.###
# #$+$  #
#  .$ # #
### #.  #
  #   ###
  #####

