
##########
#.$@     #
# ####$# #
#.     # #
#.## #$  #
#.# $  $ #
#.#  ##  #
#.#   $$ #
#.##     #
##########

