
     ####
###### .#
#      .#
#  #$#@.#####
## #   . #  #
 #  ###  $$ #
 # #   ##$  #
 #         ##
 #  ########
 ####

