
##### #####
#   ###   #
# +     . #
#   # #   #
## ## ## ##
 #    $  #
## ##$## ##
#   # # $ #
# .    $. #
#   ###   #
##### #####

