
  #######
  #     #
  # # # #
  #     #
 ####*####
 # .   $ #
 # # * # #
 # $   + #
#####*#.###
#    *  $ #
# # ### # #
#   # #   #
##### #####

