
 #########
 #       #
 #$##.##$##
## #   .  #
#  # .##  #
#  .$  # ##
## ##.##$##
#       $@#
#   #  #  #
###########

