
#####
#   #####
# #$#   #
# .*.   #
# #$#   #
#  @#   #
#########

