
    #####
#####   #
#   #$# #
# $  $  #
##$#@## #
#     # #
# $##$# ##
#  # .#  #
## ...   #
 ###..#  #
   #######

