
######
#    ##
#+$ $ #
#.#   #
#.# $ #
#   ###
#####

