
#########
#       #
# ##### #
#.    # #
#.#$$$  #
#.#@  $ #
#.  #####
#########

