
 #######
##  *  ##
#  *+*  #
#  # #  #
#  *$*  #
##  *  ##
 #######

