
#######
#     #
# #$  #
# $+$ ##
# *##$ #
#   #  #
#. .  .#
########

