
   ########
####      #
# @$*$#$# #
# . . . . #
# #$ ##$###
# . . . #
# #$#$###
#     #
#######

