
      #####
 ######   #
##   +# $ #
#   ### #####
#  *    .   #
#  ### $#   #
#### #  #####
     ####

