
###########
#    @    #
# ###$### #
# # .$. # #
# #$ . $# #
#  $. .$  #
###$. .$###
  #  .  #
  #######

