
######
# * +####
#  * *  #
# * # # #
#  * *  #
##* $ ###
 #    #
 ######

