
####
# @####
#     ##
# .#.  #
##$$$$ #
# . .###
#    #
######

