
###########
# .  #  # #
# .$$$$ . #
# .  @  . #
# . $$$$. #
# #  #  . #
###########

