
  ########
 ##     @#
##.$#**  #
# *   *  #
#  * * ###
### # ##
  #   #
  #####

