
    ####
#####  #
#      #
# $$.*.##
## $.$* #
 # . .$@#
 #  #####
 ####

