
######
#    #
#.$# #
# *  #
#.$# #
#@* *#
#.$# #
# *  #
#.$# #
#    #
# # ##
#   #
#####

