
   #####
   #   ######
#### # #    #
# @$$$... # #
#  # # ## # #
## #   #  # #
 # #####    #
 #        ###
 #  #######
 ####

