
 #######
##  #  ##
# $ @ $ #
# #***# #
# .   . #
###     #
  #######

