
  ##
 #  ##
 #  $+#
 #  ##
 # *#
#   #
# # #
#   #
 ###

