
   #####
   # @ #
   # # #
  ##.$.##
  #. $ .#
  #$$#$$#
###. $ .###
#   .$.   #
#   ###   #
##### #####

