
#############
#     #   . #
# #.#$$$#$# #
# . . @ . . #
# #$#$$$#.# #
#   . #     #
#############

