
   ####
####  #
#  *  #
#.$#$.#
#  #  #
#* * *#
#  #  #
#.$#$.#
#  @  #
#  ####
####

