
 #######
 #  #  #
 #  #  ##
##  #   #
#.****$ #
##    ###
#  ##   #
# ##### #
#      @#
#########

