
  #####
  #   ###
###.#   #
# $.$ # #
# #* $  #
#@ . ####
######

