
  ####
  #  ######
###     $ #
#  $.#### #
#  . .  . ##
#### #  .$ ###
   # #  # *  #
   #$####.$  #
   #@$     ###
   ######  #
        ####

