
######
#    #
# ##.###
# $.   #
# ##$  #
#$ $@# #
#. .$ .#
########

