
   #####
####   ##
#   ..  #
# #   # #
# ##*** #
# #     #
# .$**###
##$ $@#
 #   ##
 #####

