
##########
#.$      #
# #### # #
#.     # #
#.##$#$# #
#.#  $@$ #
#.#   #  #
#.# $$   #
#.#  #   #
##########

