
#####   #####
#   ### #   ###
#  $  ###  $  #
# *#*..@..*#* #
#  $   ##  $  #
###   #####   #
  #####   #####

