
########
#.    .#
# # ## #
#  $ . #
# # ## #
#$$$*# #
#.  @$.#
########

