
  #####
###   ##
#   .. #
#  * # #
##$# $ #
 #@$.$.#
 ###  ##
   ####

