
######
#    #
# *. #
#  $ #
##@#*#
#  $ #
# *. #
#    #
######

