
#########
#       #
# ##### #
#.    # #
#.#$$$# #
#.#@  $ #
#.    ###
#########

