
 #######
 #     #
 #$#.#.##
 # # .  #
## #.#$ #
# $.$# ##
# .#+#  #
# $$$   #
##     ##
 #######

