
#############
#   #   *   #
#   *   #   #
##$##.#+##$##
#   #   *   #
#   *   #   #
#############

