
 #######
##     #
#  $ $ #
# ##**##
# . . ###
### . . #
#####*# #
#  $ $  #
#   @  ##
########

