
  #######
###.    #
# $. .$ #
# $###$ #
# $. .$ #
# @  .###
#######

