
#########
#   #   #
# # $ * #
# .**+#.#
# $ #$  #
# .   $ #
#########

