
############
#   .  .   #
#  #### ## #
## $ $     ##
 #$# # . #  #
 #@#       $##
 #$#$##.###  #
 #.  .       #
 #############

