
####
#  #####
# $  $@##
# $#.#$.#
#       #
#   .#. #
#########

