
#####
#   #######
#    $    #
## ##...  #
##$##$##$##
#  ...## ##
#   $@$   #
#######   #
      #####

