
  ######
  #    #
 ##. # #
## * # #
# $. # #
#  .$# #
# $.$  #
## * ###
 ##@ #
  ####

