
###########
#     #   #
# *** # # #
# * *     #
# * *$#####
#   + #
#######

