
 #######
##  #  ##
# $ @ $ #
# #***# #
# .   . #
##     ##
 #######

