
########
#      #
# $.   #
## * ###
# ***#
#  @ #
######

