
#######
#  @  #
# *** #
# $ $ #
## . ##
#  # #
#  # #
# $.$#
## # #
#  . #
#  . #
######

