
###########
# .  #  # #
# #$$$$.. #
# .  @  . #
# ..$$$$# #
# #  #  . #
###########

