
#######
#  . .#
# $.$.##
# $.$. #
#@$.$. #
####$$ #
   #   #
   #####

