
########
#. *  .#
# $#$$ #
#.  @ .#
# $$#$ #
#.  * .#
########

