
  #######
### ..  ###
#   #.    #
#  $$*$$  #
###  + ####
  ######

