
 #####
##   # ####
#    ###  #
#  # @#   #
##$####   ######
# ...    ##    ##
# ...  #    ##  #
#### # #####  # ##
   # #       $#  #
   # # $ $ $$  # #
   #  #####    # #
   ##      #   # #
    ######  ###  #
         ##     ##
          #######

