
   ####
 ###  #  ####
##    ####  #  #####
#  #        # ##   #
#  $$$ #### # #  # #
###  ###  # # #  @ #
  #  #   ## # #   ##
  ####   #  #####.#
         #        #
         ####### .#
               # .#
               ####

