
#########
#.#.#.#.#
# # @ # #
#$$$$$$$#
#   $   #
#.#.#.#.#
#########

