
      #####
#######   #
#     + # #
# ###* #  #
# * *    ##
#  *  #  #
##$###  ##
 #     ##
 #######

