
 #####
 #   ###
## #   #
# **$# #
#  .*. #
#  #$# #
##  @  #
 #######

