
######
#@   #
# * *#
## # #####
 # $ $   #
 # . .   #
 #########

