
######
#    #
# .* ###
# .$.$ #
## $  @#
 ####  #
    ####

