
####
#  ###
#    #
#.*  ###
# *#   #
# *@$  #
# ** ###
###  #
  ####

