
  ######
###  . ###
#   #.   #
#  $$*$  #
###  + ###
  ######

