
    #####
#####   #
## .**@ #
#  $   ##
# ## ####
#    #
######

