
 #########
##   #   #
# $*   #+#
#  * # * #
##  ***  #
 ##  #  ##
  ##   ##
   #####

