
#######
# *   ###
# $#+   #
#    ***#
####    #
   # *  #
   ######

