
 ####
##  #####
#  * .  #
#  $.$# #
#  * *@ #
## $.$. #
###  #  #
#########

