
  ####
 ##  #
## $ ###
# $@*  #
#  * #.#
##* *  #
 # . . #
 # #$###
 #   #
 #####

