
#########
#   .   #
# ##$## #
# # *   #
# # *@# #
# # $ # #
# # ### #
#   .   #
#########

