
   ####
####  #
# $   #
# $#  ###
# @# #  #
# ## $  #
#.*  #  #
#.*..* ##
## ### ##
#    $  #
#   #   #
#########

