
  #########
###    ##+#
#   *#*   #
# #  .* # #
# #$###$# #
#         #
###########

