
########
#. *  .#
# $#$$ #
# . @. #
# $$#$ #
#.  * .#
########

