
 ####
 #  #
##  ##
# .$.###
# $ $@ #
##.$.  #
 ##  ###
  ####

