
 ######
##  $.##
#    $.#
# $.#  #
#. ##  #
##. $$###
 ##.  * #
  ###$# #
    #@  #
    #####

