
###########
#    #  + #
# $  #  # #
# #* # *# #
# #  #  # #
# #*   *# #
# #  #  # #
# ####### #
#         #
###########

