
#############
#       #   #
# @**$$$ ...#
###     ### #
  # *###    #
  ##     ####
   #######

