
   ####
   #  ######
   #    #  #####
   # # @       #
   # # $ $$##$ #
  ## ##$##    ##
  #  #     ## ###
  #    ###   $$ #
######.# ##     #
#     .#######  #
#     .  #   ####
###  .#. #
  ## . .##
   ###  #
     ####

