
  ####
###  ##
# ..  ###
# *.*   #
#@$$.$$ #
#  ##   #
#########

