
      ####
#######  #
#        #
# $$$### #
# #    # ##
# ###  $  #
#+...  #  #
## ##### ##
#        #
##########

