
#########
#  . .  #
# $#$#$ #
#  .@.  #
# $#$#$##
#  . . #
########

