
     ####
######  ##
# $    . ##
#@.***$*. #
# $    $  #
###### . ##
     #  ##
     ####

