
     #####     #####     #####     #####
     #   #######   #######   #######   ####
     # # #  #### # #  #### # #  #### # #  ##
     #       ###       ###       ###       ##
    #### #    #### #    #### #    #### #    ##
#######   #    ##   #    ##   #    ##   #    #
#   ###    #    #    #    #    #    #    # $ #
# # #  #    #    #    #    #    #    #    #  #
#       #    #    #    #    #    #    #    ###
### #    #    #    #    #    #    #    #    ##
 #   #    #    #    #    #    #    #    #    #
 #    #    #    #    #    #    #    #    #   #
 ##    #    #    #    #    #    #    #    # ###
 ###    #    #    #    #    #    #    #       #
 ####    #    #    #    #    #    #    #  # # #
######    #    #    #    #    #    #    ###   #
#   ###    #    #    #    #    #    #    ######
# # #  #    #    #    #    #    #    #    ####
#       #    #    #    #    #    #    #    ###
### #    #    #    #    #    #    #    #    ##
 #   #    #    #    #    #    #    #    #    #
 #    #    #    #    #    #    #    #    #   #
 ##    #    #    #    #    #    #    #    # ###
 ###    #    #    #    #    #    #    #       #
 ####    #    #    #    #    #    #    #  # # #
######    #    #    #    #    #    #    ###   #
#   ###    #    #    #    #    #    #    ######
# # #  #    #    #    #    #    #    #    ####
#       #    #    #    #    #    #    #    ###
### #    #    #    #    #    #    #    #    ##
 #   #    #    #    #    #    #    #    #    #
 #    #    #    #    #    #    #    #    #   #
 ##    #    #    #    #    #    #    #    # ###
 ###    #    #    #    #    #    #    #       #
 #  #    #    #    #    #    #    #    #  # # #
 # . #    #    #    #    #    #    #    ###   #
 #  @ #   ##    #   ##    #   ##    #   #######
 ##    # ####    # ####    # ####    # ####
  ##       ###       ###       ###       #
   ##  # # ####  # # ####  # # ####  # # #
    ####   #######   #######   #######   #
       #####     #####     #####     #####

