
#######
###   #
##.$. #
# $.$##
# .$. #
# $.$ #
##   @#
#######
#######

