
#######
#     ####
# # #    ##
#  * ###  #
# * * * # ##
# .# # * $ #
##   #    @#
 ###########

