
  #####
###   ###
#  $..$ #
# # ##  #
# # ##@##
#  $..$#
### #$ #
  # . .#
  #$# .#
  #  $ #
  ###  #
    ####

