
##### #####
#   ###   #
# #  .  # #
# $**#**$ #
# #  +  # #
#   ###   #
##### #####

