
 #####
 #   #####
 #  $.  @#
## $##.* #
# *.##$ ##
#   .$  #
#####   #
    #####

