
 ####
 #  ###
##    #
#  #  #
#  # ###
#  $*$ #
###.@. #
  ##  ##
   #  #
   ####

