
      ######
    ###   .#
    #  $  +#
 ####*.* ###
 #  $  ###
## $  .#
#   $ ##
#   ###
#####

