
 ###########
 # *    *  #
## ###  $  #
# .. # $# ##
# *+    $ #
##.. # $# #
 #####  $ #
     ##   #
      #####

