
 #####
##  @###
#  **  #
# #  # #
# #*$  #
# #  #.#
#  *$. #
###   ##
  #####

