
###########
#.   #   .#
# #  *$## #
# #  #  *@#
# #  #  # #
# *  #  # #
# ##$ $$# #
#.   #   .#
###########

