
 #####
###  ##
#  $  ##
#@#$# ##
# .$. .#
###    #
 ##  ###
  #####

