
      #####
      #   #
 ###### # ######
##  $ . . . $  ##
#  $###*#####$  #
# # $ . + . $ # #
#   # # # # #   #
###   #   #   ###
  #############

