
  #####
###   ###
# *   * #
# ** ** #
#. # # .#
## $ $ ##
 #  @  #
 #######

