
####
#  ####
#     ###
#  #$ . #
## #.#$ #
#  # @* #
#   *  ##
####  ##
   ####

