
#####
#  @#
# $$##
#    ###
#* #   #
# ** # #
# ..   #
########

