
######
#   ###
#   ####
## $ * ##
##$#... #
# $   @ #
#   ##  #
#########

