
#####
#   ##
#  $@#
##.#.######
 # *  $ $ #
 #.#* * * #
 # *      #
 ######   #
      #####

