
   #####
   #   #
####.. #
#      #
#******#
#      #
# $$####
# @ #
#####

