
############
# .$ .  $. #
# #$#  #$# #
# .$.  .$. #
# #$#  #$# #
#    +     #
############

