
#########
#       #
# ***** #
# *   # #
# *#$ # #
#     #+#
#########

