
#########
#@..#.. #
#.$ $  .#
##$# #$##
 #     #
##$#$#$##
#   $   #
#  .#.  #
#########

