
  ###   ###
 #   # #   #
 # # # # # #
 # $ # # $ #
 #.#.###.#.#
#  $.   .$  #
# $#$###$#$ #
#  .  @  .  #
 ###########

