
    ####
  ###  #
  #    #
  #    #
  ## ###
#### $.##
#    .$@#
#   #$.##
##### ##
  #    #
  #    #
  #  ###
  ####

