
  ####
###  ##
#.#$  ####
#+*   #  #
#.*$  *  ##
#$#  ##*  #
#  #### # #
##        #
 ##########

