
##### ####
#   ###  #
#    $@$ #
## ## ## ##
 # $ $$ $ #
 #......  #
 ##########

