
####
#  ####
#     #
#     #
### ####
 #@$#  #
 #$*.  #
## .#  #
#  ## ##
#     #
####  #
   ####

