
  ####
###  ###
#+#    #
#.#$$# #
#.# $  #
#.# $# #
#    # #
# #### #
#      #
########

