
 #####
 #   #####
 # $ $ $ #
 ###.... #
####*.* ##
#   $ $##
#   #@  #
#####   #
    ##  #
     ####

