
    ######
 #### .$ ###
 # $       #
## $$.#.$  ##
#+  ####.$ .#
#############

