
######
#    #
# *.*#
# $  #
## #@#
# $  #
# *.*#
#    #
######

