
 #######
 #     #
 #$#.#@##
 # # .$ #
## #.#  #
# $. # ##
#  #.#  #
# $ $   #
##     ##
 #######

