
#########
#  *.  +###
#   #   $ #
# ###$#*  #
# #....  ##
# ##### ##
# $ $ $$#
#       #
#########

