
  #####
 ##   ####
 #    #  #
## # ##  #
#  #     #
# $**** ##
# $ ..* #
##@ # * #
 #####  #
     ####

