
###########
#    ##   #
#@$$$$....#
##    ##  #
 ####     #
    #######

