
########
#      #
# #.*#$##
# .  .  #
# * #.$ #
# #..# ##
###$$$$#
  #@   #
  ######

