
 #######
 #  @  #
 # # # #
##* * *##
# .###. #
#  $ $  #
#   *   #
#########

