
   ####
   #  #
   #  #
   #  ########
#####$@$ $ $ #
#    **....  #
#   ## #######
#####   ##
    #    #
    ##   #
     ##  #
      ####

