
  ####
### @####
#  $$$  #
# #.*.# #
#  .* # #
## #*.# ##
#   $    #
#   ##   #
##########

