
 ######
 #....##
##$$#  #####
#   #   $  #
# $ . $#  @#
#  #   #####
########

