
 ########
##      ##
# .####  #
# .    # #
# * $$ # #
# *## #  #
# +   # ##
# $###  #
##     ##
 #######

