
  ##########
### ..     ##
#   #.# #   #
#  $$*$$$   #
### .+   ####
  ########

