
 ########
##  #   #
# $ + $ #
# # # ###
# . * .#
## ### #
# . # .##
# * # * #
# $ $ $ #
#   #   #
#########

