
 #######
##     ##
#  *$*  #
# * # * #
#  * *  #
##  +  ##
 #######

