
####
#  #####
# $  $ #
# @#*# ##
# $*..  #
## #.#  #
 #      #
 ###  ###
   ####

