
  ###########
  #    +$ . #
  # #*## *$ #
### #    # ##
#  $# #  #  #
#   $ #     #
#### .   #. #
   ###  #####
     ####

