
###########
#    .  $ #
#  $ *$ $@#
#####.#####
#    .    #
# .$ . $. #
###########

