
 ######
 #    #
## . *#
# *$* #
#  #  #
#  #  #
# *$* #
#* . ##
#  @ #
######

