
#######
#     #
# $ # ##
#  * * #
# # ## ####
#  * @ *  #
##### * # #
    # **  #
    ### # #
      #  .#
      #####

