
  #####
  # + #
### * ###
#  $*$  #
# * . # #
# ## ## #
#       #
#########

