
   #####
  ##   ####
 ## $.$   #
 #  #.#   #
## . @ #$##
#  #.# .$ #
#   . #   #
### $ $ ###
  ####  #
     ####

