
  #########
  #       #
  # # # # #
  #  * *  #
### # # # #
# +  * *  #
# $ # # # #
###       #
  #########

