
  #########
  #       #
  # # # # ###
  #  * *  + #
### # # # # #
# $  * *  # #
# # # # # # #
# #       # #
# ######### #
#           #
#############

