
  ######
  ##  ##
###   ##
#  .*$ #
#  *.$@#
##   ###
##  ##
######

