
######
#    ##
# **  #
# $ # #
# *+  #
#   ###
#####

