
########
#      #
#  ### #
#    # #
#.#$$# #
#.#@ $ #
#.   ###
########

