
########
#   @  #
# $$$$ #
# $..$##
###.$.#
  #...#
  #####

