
#########
#   #   #
# # # # #
#  *$*  #
##  *  ##
 ## * ##
  # * #
  # + #
  #####

