
#####   ###
#   #####.#
#@$  #  * #
## *   *  #
 ## * * ###
  #  ####
  ####

