
#############
#           #
#$#   #   #$#
# ### @ ### #
# $ $.#.$ $ #
#.. $.#.$ ..#
#############

