
  #########
  #   #   #
 ##*# # #*##
 #    +    #
 #  #.#.#  #
### #.#.# ###
#   # $ #   #
# $$# $ #$$ #
#   # . #   #
#############

