
     #####
     #   #
######$# #
#      $ #
# #$##.# #
# $ #+.# ###
### .... $ #
  # #.##$# #
  # $      #
  # #$######
  #   #
  #####

