
#########
#       #
# ***** #
# *   * #
# + # $ #
#   #  ##
########

