
 #######
 #     #
 #$#.# ##
 #@# .  #
##$#.#  #
#  * #  #
#  #.#  #
# $ $   #
##     ##
 #######

