
#######
#     #
# #$  #
#  .$ ##
# .##$ #
#$$ #  #
#. .  +#
########

