
   ####
 ###  #
 #+*  ##
##*# * ##
#    *  #
#  ***  #
###   $ #
  ##    #
   ######

