
###### #####
#   .###   #
# # .   $# #
#  #.# #   #
#  #.# #  ##
#  #.# #  #
#  #.#$$$$#
#    $ #  #
##   *  @##
 #########

