
########
#+$   .#
#$# ## #
#  $ $ #
# # ## #
# $ ## #
#..   .#
########

