
##### #####
#   ###   #
# @     $ #
##$##$$#$##
 #  #..#  #
 #$ #...  #
 #  #..#  #
 ## ##$####
 #  ##  #
 #      #
 #  ##  #
 ########

