
#### ######
#  # #    #
#  ###    #
# $$+*$$$##
#  ....  #
##########

