
   #####
  ##   #
  # .#$#
 ## * @#
##  ***##
#    *  #
# # # # #
#   #   #
#########

