
 #######
##  .  ##
# $ ##$ #
# # *   #
#.*   #.#
#   # # #
# $## $ #
##  +  ##
 #######

