
  ####
###  ########
#  $  .+.#  #
#  $ #$#*.  #
###$##...#  #
 ## # $$$  ##
 #  # # ## #
 #         #
 #  ########
 ####

