
    ######
 #### .  ##
 # $ $  $ #
##.$ ##*$ ##
#+$ .   . .#
############

