
 ######
 #  . ###
##  .$  #
#   # $$#
#.#.#.#.#
#$$$#   #
#@$ .  ##
### .$ #
  ######

