
 ####
 #  #
##  ##
# .$.###
# $ $  #
##+$.  #
 ##  ###
  ####

