
 #####  #####
 #   ####   #
## #$.*.$ # #
#   $.@.$   #
# # $.*.$# ##
#   ####   #
#####  #####

