
#####
#   #######
#+**$ *   ###
#     #*#   #
##### * * # #
    ##      #
     ###  ###
       ####

