
 #######
##  .  ##
#  .#.  #
# ..... #
##$#$#$##
#  $@$  #
# $ $ $ #
#   #   #
#########

