
 ######
 #  . ###
##$ +$  #
# $ #  $#
#.#.$.#.#
# $$#   #
#   .  ##
### .$ #
  ######

