
    #####
    #  ##
    #  ##
    #$ ##
##### .######
#####* * $  #
#   . @ .   #
#  $ * *#####
######. #####
    ## $#
    ##  #
    ##  #
    #####

