
    #####
 ####   #
 #.##. $#
##$#  $ #
# *  .. ##
#   #**$ #
##### @  #
    ######

