
        ####
#########  #
#      . . #
# $$$   #  #
### #### . #
  #@     ###
  ########

