
######
#    #
# .$ #
# ** #
##$. #
 #  ####
 # ##  #
 #  #  #
 #     #
 #.**$@#
 #  #  #
 #######

