
 #####
 #+$ ##
##$$ .##
#  #$ .#
#.     #
##.$$ ##
 ##.$.#
  #####

