
    ######
 #### .  ##
 #  $  $$.#
##.$ ##.$$#
#.  .   *@#
###########

