
      ####
#######@ #
#  #.*.$ #
#   .#.$ #
#  #.*.$##
##   $#  ##
 # ##     #
##$   #   #
# $  ###  #
#   ## ####
#####

