
 ####
 #  #
##  #
#.* #
##*$##
# @  #
#    #
######

