
#####
#   ##
#  *+#
# ## #
#* # #
#  # #
#  # #
# *# #
#**  ##
#  *  #
## ## #
 # $  #
 #   ##
 #####

