
##### #####
#@  ###   #
# #* $ *# #
# # * * # #
# #  #  # #
# #  #  # #
#  * ###  #
##  * #  ##
 ##  *  ##
  ###.###
    ###

