
####
#.+#####
# $  $ ##
#$ #$#  #
#       #
#    #..#
#########

