
 #######
##     ##
#  ###  ##
# #   #  #
# #      #
# #*$### #
# # *  # #
# #  # #.#
# #  # #+##
#  #* *   #
## $ #### #
 ###      #
   ########

