
###########
#         #
# #@##### #
# #     $ #
# #$###$# #
# # ..$ # #
# #$#.# # #
# $ ..# # #
# ### # # #
#    .    #
###########

