
###########
#         #
# #$#$# # #
#**+$  *..#
# #$#.# # #
#         #
###########

