
#######
#...+.#
#$$$$ #
#.*  ##
# $$  #
#.  $ #
#    ##
#######

