
#######
##    #
##.$. #
# $.$ #
# .$.##
# $.$ #
##   @#
###  ##
#######

