
#######
#  .  ###
# # #@#.###
# $.$ $.$ #
# $.$ $.$ #
###.# # # #
  ###  .  #
    #######

