
#############
# .$  .  $. #
# #$#  ##$# #
# .$. + .$. #
# #$##  #$# #
#           #
#############

