
 ###########
 #  # @ #  #
 #    #    #
## #$ $ $# ##
#  . #.# .  #
#  # #.# #  #
## #$$$$$# ##
 #. .# #. .#
 #####  # ##
     ##   #
      #####

