
###################
#                 #
# ############### #
# #             # #
# # ########### # #
# # #    #    # # #
# # # $$ # .. # # #
# # # @$ # .. # # #
# # # $$ # .. # # #
# # # $  # .. # # #
# # # $$ #    # # #
# # ### ### ### # #
# #             # #
# ##### ### ##### #
#        #        #
###################

