
 #####
 #   #######
## #       #
#  $ $ $@* #
# # ####$* #
# .     $ ##
# #$##### #
#   ..... #
###########

