
    ####
 ####  #
 # *+* ####
 #  ##    ###
### ## $# $ #
#   ##  * # #
# #     # # #
# #  #### # #
# ####   .  #
#      ######
########

