
########
#      #
# $.#..##
##$.$$@ #
# $.#   #
#   #####
#####

