
    #####
#####   #
#  $    #
# #.# #####
#  $      #
# #.###   #
#  $  #####
###.# #
#     #
#@  ###
#####

