
      #######
 ######  #  #
##   ##* $  #
#  #  .  #  #
#*####@####*#
#  #  .  #  #
#  $  ##   ##
#  #  ######
#######

