
  #####
###   ###
# $ # $ #
# *   * #
#.**@**.#
#       #
#########

