
####
#  #######
#   $@#  #
#  #**.  #
##$# .#  #
#  # *# ##
#    *  ##
#  # ##  #
###      #
  #   ####
  #####

