
###########
#         #
# # #.# # #
#  *   *  #
#####$# ###
   # * *#
   # @  #
   ######

