
   ########
 ###      ##
 #   ####  #
## # *   # #
#@ $***. * #
#  # *   ###
#  # #####
##   #
 #####

