
########
#   #  ####
# # @     #
# # $ $$# #
#  #*##   #
##  *.  ###
 ##.. ###
  #  ##
  #  #
  ####

