
 ######
##    ##
#  **  #
# *  # #
# +# $*#
# ## * #
#   #  #
###   ##
  #####

