
#####
#   ##
#  $ #
##.#+######
 # $    . #
 #.#$$$$#.#
 # .    $ #
 ######.#.##
      # $  #
      ##   #
       #####

