
      ####
   ####..#
 ###  #..####
##    #.... #
#  #$    #  #
# $#     # ##
#  #######  #
# $$ $ $@$$ #
#        #  #
#############

