
##########
# .# .  .#
#  $$#$  #
#. # *.$ #
## $ #$@##
 #    .##
 #######

