
#### ####
#  ###  ##
#   $  $@#
#  #...#$#
# $#. *# ##
##  ...$  #
# $##$##  #
#        ##
####   ###
   #####

