
 ####
 #  ###
 # .  #
## $  #
# *#* #
#  $ ##
#  + #
###  #
  ####

