
#########
#.  +  .#
#.#$$## #
# # $   #
#   $ # #
# ##$$#.#
#.  $  .#
#########

