
    #########
    #       #
#####$##### #
#         # #
# ### ### # #
# #..$ .# # #
# #.* $.# # #
# ### ### # #
#    $    # #
#####$##### #
    #@      #
    #########

