
###########
#   ##    #
# $ $ $ $ #
# # * * # #
# ##* *## #
# . .@. . #
###########

