
##########
#   ##   #
# $ @  $ #
## #### ##
#  ..## #
# $.*. $#
#  #.## #
###  #  #
 #     $#
 #   #  #
 #  #####
 ####

