
 #########
##  *.#  ##
#  # $ *  #
# #.$#$.# #
#  * $ #  #
##  #.*  ##
 ##  #  ##
  ## @ ##
   #####

