
 #######
 #  .  #
 #  $# #
###**@ ##
 #  $# #
 #  .  #
 #######

