
       ########
#########   ###
## ....   #   #
#  #@###    # #
# $$$$ # #    #
#      #   # ##
##########   ##
       ########

