
#########
#       #
# #.### #
# #.  $ #
#*$+$$# #
# #.  $ #
# #.### #
#       #
#########

