
   ####
####  #####
# @       #
# #   # #$##
# $ # $ #  #
#*#*##  #  #
# .. #$  $ #
# ...  #####
########

