
#######
#     #
# #$  #
# $.  ##
# .##$ #
#$$ #  #
#. .  +#
########

