
 #########
 #   @   #
##*$*$*$*####
#  # # #    #
#  . . . *  #
##### ####  #
    #       #
    #########

