
  #####
 ##   ##
##  .  ##
# $#$.  #
#@* .$. #
# $.$*$ #
##  .  ##
 ##   ##
  #####

