
###########
#      #  #
#  ###    #
# $$+*$$$ #
## ....  ##
 #########

