
#######
#     #
#. .$.###
#$$ $$ @#
#. . .$ #
#  #  ###
#######

