
   ####
   #  ###
   #    #
 ###  # #
 #@****.#
 # # *.##
 # #   #
## #$# ##
#   $   #
#   #   #
#########

