
    ##########
    #..+.... #
#####$$#$$##$##
#    $ #   $  #
#   $  . #    #
#  #########  #
####       ####

