
 #######
 #  #  #
 #  #  ##
##  #   #
#.****$ #
##   @###
 #  ###
 ####

