
  ####
  #  #
  #  #
###$.#
#  $.##
# #$. #
#   @ #
#######

