
###########
#    .    #
# # #*# # #
#*.$$@$$..#
# # # # #$#
#    .    #
###########

