
  ###
 #   #
#+ # #
# $   #
#.$ # #
 ##   #
   ###

