
   ####
####  #####
# @   $   #
# #   # #$##
# $.# $ #  #
#*#*#   #  #
# .. #$  $ #
# ...  #####
########

