
#######
#     ####
#+***    #
#   #*#  ##
###   **$ #
  ###     #
    #######

