
   ######
   #    ##
  ## ##  #
###   ## ##
#  $$$#. .#
# #@$  ...#
#  $$$#.*.#
###   ### #
  ## ##   #
   #    ###
   ######

