
#######
#    .#
# #*#+###
# $  *  #
###$ *  #
  # ### #
  #  *  #
  # # ###
  #   #
  #####

