
#######
# .   #
# *$@ #
# *   #
#.# ###
# *   #
##$$# #
 #  . #
 ######

