
    #######
   ##      #
  #  ##.##  #
 # $      #  #
#  ##     ##  #
#    ##$##  # #
###  ##.## $# #
# .  $.@.$  . #
# #$ ##.##  ###
# #  ##$##    #
#  ##     ##  #
 #  #      $ #
  #  ##.##  #
   #      ##
    #######

