
   #########
#### .    .#
#  . *$$$$##
#  # .    .#
## #########
# $   @ #
#   #   #
#########

