
   ######
####  . ##
#+ $  $$.#
## ###.$$#
 #.      #
 #########

