
  #####
 ##   ##
##  .  ##
#  *$.$ #
# . #$+ #
#  * .$ #
## $.$ ##
 ##   ##
  #####

