
####  ####
#  ####  #
# $$  $$ #
# .$..$. #
## .  . ##
 ## @  ##
  ######

