
  #########
###    *  ##
#@$$$..* * #
# # ##.# # #
#          #
############

