
###########
#    .    #
# #$# #$# #
#..$ @ $..#
# #$# #$# #
#    .    #
###########

