
  #####
 ##   ##
## $#  ##
# $. .$ #
# .$* . #
#  .$*  #
##  .$ ##
 ## @ ##
  #####

