
##########
#   ##   #
# #$##$# #
#.@$   # #
#.##$# # #
#.## $   #
#.#  #   #
#.#  $   #
#.#   #  #
##########

