
#############
#     #     #
# # $$#$$@# #
# ### # ### #
#    . .$ $ #
#.. $.#.  *.#
#############

