
##########
###   *  #
#   $$*  #
# ..*.*$@#
##      ##
##########

