
###################
#   ...  @  ...   #
# $$$  #####  $$$ #
##   ###   ###   ##
 ##  #       ##  #
  ####        ####

