
#####
# + ####
# $**  #
# $ $  #
# .. ###
##   #
 #####

