
####   #####
#  #####   #
#  $ @  $  #
#  # ...# ##
##$##.#.# ##
#   $.#*#  ##
#   #   $$  #
#########   #
        ##  #
         ####

