
####
#  ####
#  ..+#
#  # ##
## #  #
#  #  #
# $$$ #
#  #  #
#######

