
####
#  #####
# $@$  #
# $#*# ##
#  ...$ #
## #.#  #
#       #
#    #  #
#########

