
  ####
  # @#
 ##.$#
 # * #
## * ###
#  *   #
#  *   #
## .$ ##
 ##  ##
  ####

