
  #####
  #   #
  #*$ #
  #   #
###  ##
#.#  #
# **$#
# *  #
# * ##
##+ #
 ####

