
 ######
##   @##
# $*#$ #
# # $. #
# .  # #
#  #.  #
##    ##
 ######

