
######
#    #
#.##.###
#$ . $ #
# ## $ #
# $ $# #
#. *  +#
########

