
#######
#     #
# # $ #
#  *$###
##..*..##
 ###$*  #
  # $ # #
  # @   #
  #######

