
 #########
 #.  @  .#
 # ***** #
###     ###
# $  #  $ #
#   ###   #
##### #####

