
#########
#   @   #
# #$#$# #
# # .  *#
# #$#.# #
#*  . # #
# #.#$# #
#       #
#########

