
########
#      #
#+****$##
###     #
  #  #  #
  ####  #
     ####

