
  #####
  #   #
  # $ #
###@$ #
# *** #
# . * #
# . # #
##    #
 ######

