
##### #####
#   ###   #
# .$ .  . #
#   # # $ #
## ## ## ##
 #  @$ $ #
## ## ## ##
# $ # #   #
# *  .  . #
#   ###   #
##### #####

