
#######
#  #  #
# .#  #
#  #$ #
# $$ .#
#. #  #
# $#. #
#  #  #
#$##.##
#  #  #
## ## ##
# . *$ #
#    @ #
########

