
#######
#  # @#
# $.$ #
# .$. #
# .$. #
# $.$ #
#  #  #
#######

