
########
#      #
# ****+#
# *   ##
# *#$ #
#     #
#######

