
     #####
  ####   ##
 ##  $$ $ #
 #    .#  #
 #  .#    #
##.#$ $* ##
#    . ###
# @.####
#####

