
  ####
  #  #
###  ###
# .$.  #
# $ $  #
##+$.###
 ##  #
  ####

