
    #####
    #   ####    #####
    #      #    #   ######
    ## $$  #    #        #
   ####  $##    ## ...  .#
   #   $$ ##     ##  #. .#
#### ## #  #      #  #.  #
#   $## ## ############ ###
# #    $                  #
#   ### ### ###########   #
##### #  @  #         #####
      #######

