
########
#      #
#*##.#.#
#  .$  #
# ## $ #
# $ $#$#
#. *@ .#
########

