
#####  ####
#   ####  #
#      $ @#
##$#####  #
#  #...$ ##
#  $. .#  #
#  #...##$##
##$###$##  #
#       $  #
#   ##  #  #
############

