
####
# @#######
# $      #
## ##.##$##
 # #   .  #
## # .##$ #
#  .   # ##
#  ##.##  #
#  $   $  #
#  #  ##  #
###########

