
########
#      #
# #### #
#.   # #
#.#$$$ #
#.#@ $ #
#.    ##
########

