
####  ####
#  ####  #
# $   #$ #
# $##.*  #
#   ..# ##
## #..   #
#  *.##$ #
# $#   $ #
#@ ###   #
#### #####

