
    #####
##### @ ##
#    $#$ #
#.  # .  #
##$# *.* #
#  #$ . ##
#  $  # #
# .##   #
#########

