
#########
#   .   #
#  . .  #
##. . .##
##$#$#$##
#  $@$  #
# # $ # #
#   #   #
#########

