
###########
# @#   *  #
# $#   $  #
#   ## #  #
# $    # ##
#  $#  #..#
# $$ ## ..#
#    #  ..#
####   ####
   #####

