
        ####
      ###  #
#######    #
#   $      #
#   $### ###
###.$... .#
  # $#    #
  # $ #####
  # @ #
  #####

