
     ####
######  #
# $.  * #
#@ *$$. #
# $.  . #
####  ###
   ####

