
 #######
 #  @  #
 # #*#$##
 # # .$ #
## #.#$ #
#  . #  #
#  #.#  #
#     $ #
##     ##
 #######

