
 #######
##     ##
#  *$*$ #
# * #+* #
#  * *  #
##  .  ##
 #######

