
    ####
    #  #
#####  ###
#   **$  #
#   .*   #
#  # * ###
#### @##
   ####

