
   #####
  #     #
 ## # # ##
#  + * *  #
# # # # # #
#  * * *  #
# # # # # #
#  * * $  #
 ## # # ##
  #     #
   #####

