
#########
#   #  @#
# *     #
##*### ####
 # .#     #
 # .#$$ $ #
 # .# #####
 #      #
 #  #   #
 ########

