
  #####
  #@  ##
 ##**. #
 # $ # #
##   # #
#  $ # #
#.***  #
#     ##
#######

