
 #####
 #   #
 # $ #
 # # ##
##* * #
#. @ .#
# * *##
## # #
 # $ #
 #   #
 #####

