
 #####
 #   #
##   ###
# **.. #
#  $ $@#
#  ##  #
########

