
######
#   .#
# ##+###
# $ *  #
##  *  #
 #  ## #
 ## *  #
  #$ ###
  #  #
  ####

