
  #####
  # @ #
###$#$#
#     ######
# $$# # .. #
##     $   #
 #  #   ...#
 ###########

