
#######
#     #
#.### ###
#.# $ $ #
#.#  $  #
#.# $ $ #
#.## @###
#     #
#  ####
####

