
###########
# .  #  . #
# #$$$$ . #
# .  @  . #
# . $$$$# #
# .  #  . #
###########

