
########
#.   $+#
# #$##$#
# $  $ #
# # ## #
#   .# #
#.    .#
########

