
###############
#   #   #     #
# # # # # ### #
#  $.$   $  # #
###.#.###.# # #
#  $.$  #   # #
# # # # # ### #
#   #   # #   #
### ##### ### #
#  $.  $ $. # #
# # # ###.# # #
# #   # #   # #
# ##### ##### #
#            @#
###############

