
 ##########
 #        #
##*##$#+  #
#  #   # ##
# **** # #
#      # #
# # #### #
#        #
#######  #
      ####

