
######
#    #
#  $@#
# $###
#.$..#
#..$.#
###$ #
# $  #
#    #
######

