
   ####
   #@ #
  ##$ ###
  # *   #
###  *  #
#  * *###
#  *  #
### . #
  #####

