
#########
#   +   #
# $ * $ #
# ##.## #
#   *   #
#########

