
       #####
 #######   #
##   ..# $ #
# $ $..# $ #
# $ #..$ $ #
# $ #..   ##
# @ #######
#####

