
  ####
  #  ####
 ##  $  ###
 #  ##$.. #
 # $@# .  #
## #$$$# ##
#  . #   #
# .. ##  #
###     ##
  ####  #
     ####

