
#############
#           #
#$# $ #   #$#
# ###   ### #
#  $ .#.$ $ #
#+.$ .#.$ ..#
#############

