
########
#      #
# #### #
# #  # #
# #.$* #
# *  * #
# #$.* #
# #  # #
# #  # #
# #@## #
#      #
########

