
  #####
  #   ##
###$.@ #
#  $.  #
# # * ##
#   ###
#####

