
##### ####
#   ###  ##
#    $    #
##$##@# #$#
 # #....  #
##  ....# #
# $# # ##$##
#  $ $ $   #
#  #####   #
####   #####

