
       ######
    ####   .#
    #      +#
 ####*#.* ###
 #      ###
##$$$$#.#
#       #
#   #####
#####

