
######
#    #
# ## ##
#  .$.###
###$@$  #
  #.$.# #
  ## ## #
   #    #
   ######

