
  #######
###     #
# $*#$# ##
# #. $.  #
# #. @.# #
#  . $.# #
##$# #*$ #
 #     ###
 #######

