
###########
# .  #  . #
# #$$$$.# #
# .  @  . #
# #.$$$$# #
# .  #  . #
###########

