
######
#    ###
# $#   ######
#  $ # $ # @###
# #.$.$#.  .  #
#   #$   #  # #
###   # .  ## #
  ###   #.    #
    #####   ###
        #####

