
 #####
 #  .##
##$$  ##
# $   .#
#@$##$ #
##. $ ###
 ##.  . #
  ###.# #
    #   #
    #####

