
    #####
  ###   ##
 ##   *  ##
##  ## #  #
#  ##   # #
# **  . # #
#  ** $ # #
##  ####  #
 ##   @  ##
  ########

