
##########
# .#    .#
#  $ #$ .#
#. # $.  #
##*$$#$ ##
 #    +##
 #######

