
 #####
##@  ##
# $#  ##
#  ##  ##
#   **  #
###  ** #
  ##  **#
   ####.#
      ###

