
  ####
  #  #
### *####
# $  .  #
#  *   *#
###@* * #
  ## *  #
   ###  #
     ####

