
        ####
#########@ #
# $ $ $ $  #
#  * * *   #
## # # ## ##
 #. . . . #
 ##########

