
    #####
   ##   #
 ###    #
##   $ ##
#@.*** #
#    * #
########

