
#######
#     ##
#.**.. #
#.#  $ #
#.#  $ ##
#### $$ #
   #  $@#
   ###  #
     ####

