
 #########
 #       #
## ##$## ##
#  . * .  #
# #$###$* #
#  . * .  #
## ##$## ##
 #   @   #
 #########

