
  #####
###   ##
#  . * #
# .$.#@#
## # $ #
 # $ # #
 ###   #
   #####

