
######
#.$  #
#.$  #
#.$  #
#.$  #
#+$###
#   #
#####

