
###########
#         #
#$# #$# # #
#..*  $*..#
# #@#$# # #
#  $ .    #
###########

