
     ####
#### #  #
# +### $#
# *  #  #
# *  *  ##
###  * * #
  ## * # #
  #  ##  #
  # *#  ##
  #    ##
  ######

