
########
#   #  #
# $ @ $#
## #.# ##
 #$$$ $ #
 #..... #
 ########

