
     #######
     #     #
###### ###$##
#   # *   + #
#     * * * ##
#### ######  #
   #         #
   #  ########
   ####

