
   #####
  #     #
 ## # # ##
#  $ * *  #
# # # # # #
#  * + *  #
# # # # # #
#  * * *  #
 ## # # ##
  #     #
   #####

