
##### ####
#   ### @#
#      $$#
## ##.## ##
 #  $.$ $ #
 # . . .  #
 ##########

