
#######
#@. . #
# $ $ #
#.$## ##
# . #  #
# $$$$.#
# . .  #
########

