
#######
#     #
# *.. #
# . *$##
# *$*  #
# $@*  #
#####  #
    ####

