
#######
#     #
#.@ $ #
#.# $ #
#.# $ #
#.  $##
###  #
  ####

