
#######
#@. . #
# $ $ ##
## ##  #
# $ #$.#
# . #  #
#.$$$$.#
# . .  #
########

