
     ####
######  ####
# $        #
# #$#$$### #
# # #      #
# $ ###### ##
# $      #  #
# @#......  #
#############

