
#######
# . . ####
# $ $  $.##
## # $.   #
## #### $.#
# . . ##  #
# $ $   $.#
######## @#
       ####

