
  ####
  #  ###
  #    ##
###  #  #
#  $.@# #
# .$.$. #
##.$##$##
 #     #
 #######

