
 ####
 #  ######
 #   $@$ #
## ##*## #
#  # . # ##
#  $...   #
## # . #  #
#  ##.##$##
#  $  $   #
#  #  #   #
###########

