
    #####
   ##  @#
  ## *$ ##
 ## * *  ##
## *   *  #
# *  #  $ #
#.. ####  #
#####  ####

