
      ####
  #####  ####
 ##   #  $  #
 # .# # #*  #
## *  @  * ##
#  *# # #. #
#  $  #   ##
####  #####
   ####

