
#########
#   *   #
# $ * $ #
# ##.## #
#  * *  #
##  +  ##
 #######

