
 ####
 #@ #
##.$###
# $ $ #
# .$. ##
# $.$  #
##.#.  #
 #   ###
 #####

