
 #####
 #.  #
 ## *#
###  ##
#  @$ #
# $   #
##* ###
 #  .#
 #####

