
  ####
  #  #
 ## $###
 #  .$@###
## . *$  #
# .  $.  #
#  . * ###
##  .$ #
 ###$ ##
   #  #
   ####

