
##########
#.     ..#
#.##$$####
# ##   ###
# $ ## $ #
# $    $ #
# #   ## #
# ##$$##.#
#..     +#
##########

