
###############
#             #
# ########### #
# #        @# #
# # ####### # #
# #       # # #
# ####### # # #
#   $   .   # #
# $ ###.#.### #
# $ #  ...  # #
# $ # # # # # #
# $ #   #   # #
# $ ######### #
# #           #
###############

