
      #####
#######   #
#  * # *  #
#.#$ # $#.#
#  * @ *  #
#   ###   #
##### #####

