
 #####
 #   #
 #. $#
 # $ #
##.. ##
# **$ #
#  @  #
#######

