
#########
#.  #   #
# . $ . #
# * $$*$#
#   #  +#
#########

