
###########
#     #   #
# ***$# # #
# *   +   #
# * *$#####
#   . #
#######

