
    #
 #######
 #  #  #
 #@ $  #
 #  *. #
###* *###
 # .*  #
 #  $  #
 #  #  #
 #######
    #

