
  ######
  # *  #
###    ##
# *.@** #
#  $*   #
###  ####
  #  #
  ####

