
############
# .$  . $. #
# #$#  #$# #
# .$.  .$. #
# #$#  #$# #
#    +     #
############

