
   ####
 ###  #
##    ###
# $ $   #
# #$# #$##
# . .$.  #
##.@. #$ #
 ###.   ##
   #  ###
   ####

