
######
#   .#
# ##+###
# $ *  #
##  *  #
 ## *  #
  # *  #
  # $###
  #  #
  ####

