
    ####
    #  ###
    #  . #
    #  $ #
    ## ########
 #####   ##   #
 #  #  *      #
##.$# *@* #$.##
#      *  #  #
#   ##   #####
######## ##
     # $  #
     # .  #
     ###  #
       ####

