
 #######
 #     #
 # $ $ ####
### ## .  #
#   #. $  #
# @  .#*###
### #.. #
## $ #  #
#   $ $ #
#   ##. #
#########

