
 #######
 #     ##
 #$#.#  #
 # # .  #
## #.# ##
# $. #$#
# $#.#@#
#     $#
#  #   #
########

