
#### ####
#  ###  #
#   @   #
# *.##. #
##  $  ##
 ##$#$##
##  $  ##
# .*#.* #
#       #
#  ###  #
#### ####

