
#######
#     #
# **. #
#   $ #
##@##*#
#   $ #
# **. #
#     #
#######

