
   #######
####     #
#  * #.* #
# #$ . *##
# $ # #  #
# $ #.   #
# @ #    #
##########

