
 ##########
 # *      #
## ##$#+  #
#  #   # ##
# **** # #
#      # #
# # #### #
#        #
#######  #
      ####

