
########
#    * #
#   $# #
#$#. . #
#@$$## #
#.$  ..#
########

