
     #####
######   #
#    $   #
#+*****. #
#    $  ##
######  #
     ####

