
 ######
##    ##
#  ##  #
# #  # #
#.  .#$##
# # * $ #
# # * $@#
#  .. $ #
#########

