
###########
#    #  * #
# *+$$  . #
# *$  $.. #
# *  #    #
###########

