
#######
#     #
# *** #
# #@$ #
# #$  #
# ..* #
#  #  #
#######

