
###########
#.   *   .#
# $  +  $ #
# # #*# # #
# #  *  # #
# ###$### #
#    *    #
###########

