
####
#  #
# $#####
# .$ $ #
# .... #
# *#####
# .$  #
# $$  #
# @   #
#######

