
########
#. .  .#
# $ #$.#
# #@$  #
#  $ #.#
# $#$$ #
## .  .#
 #######

