
#####
#   #
# #.#
# $$####
# .+$. #
# $.$# #
#      #
########

