
 ######
##    ##
# $#   #
# .*...#
# $@$  #
#####$ #
    #  #
    ####

