
##########
# .# *  .#
#    #$ .#
#. #$ .$ #
##$$@#$ ##
 #    .##
 #######

