
##### ####
#   ### @#
#   $.$ $#
## ##.## ##
 #$  .    #
 #   .    #
 ##########

