
    #####
   ##. @#
 ###.$$ #
## .$$. #
#  $$.###
#   .##
######

