
  #######
###  *  ###
#   ***   #
#  $...$  #
##$##.##$##
 #   #   #
 ### @ ###
   #####

