
####
#  ####
#  ..+#
#  # ###
## #   #
#  # $ #
# $ $# #
#  #   #
########

