
#######
# .$  #
#  #  #
#  #  #
# $#$ ##
#  #   #
#  # * #
#***.. #
# @*   #
########

