
########
#      #
# $ $. #
# $#$. #
# $@$.##
###...#
  #####

