
  #####
 ## .@##
 #  *  #
 # $*$ #
 #..#..#
##$ . $##
# $ # $ #
#   #   #
#########

