
  #########
###       #
#   .##.#$#
#  * .$$# ##
###  # $+  ###
  ## #  # .  #
   #$####.$  #
   #       ###
   #########

