
    ######
    #    ##
  ###.##  #
  # $ $ # #
### # # # #
# .  *  . #
# # # # ###
# # $ $ #
# @##.###
##    #
 ######

