
#########
#   #   #
# $ @ $ #
## ### ##
#  .#.  #
# $...$ #
##$.#.$##
#  ###  #
#   $   #
#  ###  #
#########

