
   ####
####  #
# .$* ##
#   $  #
# .# . #
# *#$@##
##    #
 ######

