
#######
#     #
#.### ###
#.# $ $ #
#.#  $  #
#.# $ $ #
#.#@ ####
#    #
#  ###
####

