
         #####
        ##   #####
 ########  $     #
##      ..  ###  #
#  ######.## .# ##
# $#+         # #
#  #  #######$# #
# $## # *       #
#   $ #   ####  #
####  #####  ####
   ####

