
#############
# .$  .  $. #
# #$## ##$# #
# .$. + .$. #
# #$#   #$# #
#           #
#############

