
 ####
##  #####
# $ #   #
#  *  # #
## #.*  #
 #  *.# ##
 # #  *  #
 #@  # $ #
 #####  ##
     ####

