
##### ####
#   ### @#
#   $ $ $#
## ## ## ##
 #$    $  #
 # ...*.. #
 ##########

