
######
#    ###
# *  $ #
## *   #
 #* # ##
 # *# #
 ##+  #
  #####

