
#######
#.   .#
#  $# #
# $@# #
# $#  #
# * *$#
#.   .#
#######

