
  #####
  #+. ####
  ##.  $ #
   #.# $ #
####.#$# #
#  #.#   #
# $#.## ##
#  $ $ $ #
#        #
##########

