
     ###
    #   #
    # # #
    # $ #
 ####.#.####
#   . $ .   #
# #$#$#$#$# #
#   . $ .   #
 ####.#.####
    # $ #
    # # #
    # @ #
     ###

