
########
#.$  $.#
#.$  $.#
#.$  $.#
#+$#$ .#
#  #   #
########

