
  ####
  #  ####
  # *   #
### ....#
#  $*$$ #
#   . ###
###$*$@#
  #    #
  ######

