
 ####
 #  #####
##  * $@#
#  .#.  #
# $ *  ##
#####  #
    ####

