
##### #####
#   ###   #
# +     . #
#   # #   #
## ## ## ##
 #     $ #
## ## ## ##
#   #$# $ #
# .    $. #
#   ###   #
##### #####

