
########
#  #   #
#    # #
# #  # #
#.#$$$ #
#.#@ ###
#.   ###
########

