
   #######
   #     #
#### # $.####
#  . *.# $  #
#  $ #.* .  #
####$$ # ####
   #   @ #
   #######

