
 ######
 #    #
 #    ###
 ##*#   #
## . ## #
#     # ##
# #.#  $ #
# $.###$ #
### ##   #
  #   $$@#
 ##..##  #
 #   #####
 #   #
 #####

