
#############
# .....    .#
# $ $ $ $ $ #
###@#########
#    $ #
#*   # #
#  ### #
#      #
#  #####
####

