
########
#.$   .#
#  $#$ #
# #   $#
# .$ # #
#$#. . #
#+$   .#
########

