
#####
#   #
#   ##
## $ #
#+** #
#    #
######

