
#############
#     #     #
# # $$#$$@#$#
# ### # ### #
# $  .#.  $ #
#..  . .$ ..#
#############

