
       ####
  ######  #
 ##  $  $ #
##  $ #$  #
#  $ #   $#
#   # ##  ##
###$  ..#  #
  #  #*...@#
  #   ..####
  #  ####
  ####

