
#########
# #   # #
# $$# * #
# *  .. #
# +$#   #
# #   # #
#########

