
########
# @ #  ##
#  *#$.##
## * $. #
##      #
 ###   ##
  #######

