
 ####
##  #####
#   $   #    ####
#  $# # ######  #
##$ # # #       #
 #    ...+****$ #
 ########      ##
        ########

