
     ########
   ###..... #
####  .  ##$##
# $   #      #
# $$ $. # $$ #
# @########  #
####      ####

