
#####
#   ######
# $ #    #
# #****# #
#        #
### ***#+#
  #  #   #
  #  #####
  ####

