
  ######
  #    #
### ## ######
#    # #    #
# .*$# #$*# #
# #.  @  .# #
# #*$# #$*. #
#    # #    #
###### ## ###
     #    #
     ######

