
 #####
 # @ #
 # $ #
##$$ ##
# $...#
# $#$.#
# ..$.#
###   #
  #####

