
 #####
 #   #
## # ###
#  * $ #
#  *** #
#.* * @#
#   *  #
########

