
###########
#         #
# ####### #
# #   ### #
# #$# ### ###
#  .  *@**  #
### # ### # #
  # #     # #
  # ####### #
  #         #
  ###########

