
  #####
 #     #
#  *## ###
# #   *   #
# * + # $ #
# *   #   #
#  ### ###
 ##

