
    ##############
    #         #  #
    # ####### #. #
    #    .       #
############# # ###
#        .    #   #
# # ######### # # #
# # # . . . .  .# #
# #$  $ $@$ $ # # #
# # # ######### # #
#   #    $        #
### # #############
 #       $    #
 # $# ####### #
 #  #         #
 ##############

