
     ####
 #####  #
 #...   #
#### # *#
# $     #
# $$##  #
#  @ ####
######

