
   ####
 ###  ###
 #   $$ ##
 # #     #
 # #  #* #
 # # $#. #
## #$@#*.#
#    $#..#
#   # .* #
#######  #
      ####

