
     #####
  ####   #
  #  . # ###
  # $. $ $ #
  # #.## $ #
###@#..#$  #
#   ##.#  ##
# $ $ .# $#
## ###.## #
 #        #
 #####  ###
     ####

