
########
#.$   .#
#@#$#$ #
#$# $. #
# . $# #
# #. * #
#.  $ .#
########

