
   ####
  ##  #
### * ##
#  *   ##
# #  #  ##
#@ ** *$.#
# #  #  ##
#  *   ##
########

