
     ##
    #  #
 # # $ ###
#.#.$ .  .#
#  $+# $ #
# $ #.$ #
#  # $.#
 ## $ #
  #   .#
   ####

