
#####
#   #########
# $    ##   #
##$#...     #
## ##$#### ##
#  ##..+ #  #
#  $   # $  #
#  ###$###  #
#####      ##
    #   ####
    #####

