
  #########
  ##  ##  #
####.$ . $###
# $ $  #. ###
#  .# @ #.  #
### .#  $ $ #
###$ . $.####
  #  ##  ##
  #########

