
 #######
##  *  ##
#  *+*  #
#  ###  #
#   *   #
#  *$*  #
##  #  ##
 #######

