
#######
#   + ###
# # #   #
# *   # #
# # ### #
# *   $ #
###*#*###
# $   * #
# ### # #
# #   * #
#   # # #
### .   #
  #######

