
  ####
  #  ###
  #  $ #
  #*   #
### # ##
#  *  #
# # # #
#  *# #
###+  #
  #####

