
######
#   .#
# #*+###
# $ *  #
##  *  #
 ## #  #
  # *  #
  #$ ###
  #  #
  ####

