
  #####
###   ###
# . $ . #
# #.$.# #
# $ # $ #
### @ ###
  #####

