
###########
#         #
#  #*# $  #
# $*+*$$$##
## ....  #
 #########

