
#######
###   #
##.$. #
# $.$##
# .$.##
# $.$ #
##   @#
##  ###
#######

