
 #########
 #   #@  #
 #   **#$##
### #     #
# $$**#.# #
# # #  .  #
#   ##.  ##
##    .#$#
 #  ##   #
 #########

