
###########
#   *  *  #
#  $# #$#.#
### * *   #
#   # #   #
#   * # ###
##### # #
#+*     #
#########

