
#######
#     #
# #.$ #
#  .$ ##
# *##$ #
# $ #@ #
#.$.  .#
########

