
  #########
  #       #
### # # # #
# +  * *  #
# # # # # #
# #  * *  #
# $ # # # #
###       #
  #########

