
######
#   .#
# ##+###
# $ *  #
##  *  #
 ## #  #
  # $ ##
  #  ##
  ####

