
       #####
       #   #
    ####$*@#
#####.... ##
#   ...## #
# # ##### #
# $  $  $ #
# $  $  $ #
####   ####
   #####

