
#####
#   ####
#      ##
### ##  #
 #  ### ##
 #    .*+#
 #  # ## #
 #### $  #
    # $ ##
    #  ##
    ####

