
#######
#     #
#$#. .##
#  *$$ #
# .#@$ #
# $ $# #
#. .  .#
########

