
###########
#     #   #
# ***$# # #
# * +     #
# * *$#####
#   . #
#######

