
#############
# .$  .  $. #
# #$## ##$# #
# .$. + .$. #
# #$#   #$# #
#     #     #
#############

