
    #####
 ####   #
 #@*    #
## # # ##
# $***. #
#  # #  #
#  #    #
#########

