
######
#    #
#*##.###
#  .$  #
# ## $ #
# $ $# #
#. *  +#
########

