
 ######
 #    ###
## #$$ @#
#  * .# #
#   *#  #
# #. * ##
#     ##
#######

