
####
# @#####
# $ .  ##
#  #.#  #
# $ *   #
# $ .#  #
#########

