
########
#. *  .#
# $#$$ #
#  .+  #
# $$#$ #
#.  * .#
########

