
 #####
##   #
#  # ###
# * $  #
#. * #@#
# * *  #
## *  ##
 ######

