
  ####
 ##  ##
##@   ##
# $$$$ #
#..$...#
##    ##
 ##  ##
  ####

