
  #####
 ## @ ##
 # .$. #
 # * * #
 #$ #.*#
##  #  ##
# $.$.$ #
#   #   #
#########

