
 #####
 #   ###
 # # $ #
 # $   ####
####* ...+#
#     # # #
#  #  # # #
## #### # #
 #    $ $ #
 #  #######
 ####

