
#########
#  @ .  #
#  .#*$ #
# $. .$ #
##$.##$ #
 #  ##  #
 ########

