
#########
#   *   #
# $ * $ #
# ##.## #
#   +   #
#########

