
    ####
 ####  #
 #     ##
 #$***  #
 # * #  #
## *   ##
# @*.###
#    #
######

