
#########
#       #
#  #### #
#..   # #
#.#$$$$ #
#.#@  $ #
#.  ##  #
#########

