
       ###
   #####+#
####.    #
#  .#**# #
#    $ * #
##$# $  ##
 #    ###
 ######

