
########
# $  . #
#+##*$.#
# $  . #
#  $ # #
# #$## #
#.$  . #
########

