
#######
#   + ###
# # #   #
# *   # #
# # ### #
# *     #
###*# ###
#  *   #
# $# **#
#    # #
####   #
   #####

