
####
#  #####
# $  $ #
#  #*# ##
#@$...  #
##$#.#  #
 #      #
 ###  ###
   ####

