
   #####
   #   #
   #. $#
   # $ #
####.. ##
# $ **  #
# .  @$ #
#########

