
             ##
    ###     #  ###
   #...#    #     #
 ###@ . #   # ##  #
#   #  . #  # ## #
# $  #  . # # ## #
#  $  #  . ## ## #
# # $  #  . # ## #
#  # $  #      # #
 # ## $  #  ## # #
 # ###$$$ ##   # #
 #           # # #
 # ########### # #
#                #
#   ###########  #
 ###           ##

