
   #####
  ##   #
  #  # #####
### # *  $+#
#  *  *  $.#
#  *  ######
#  *  #
#######

