
    ######
   ## ...#
  ## $ # #
  # $ ...#
###$  # ##
# $@#   #
#  $ #  #
#   $  ##
##  #  #
 #######

