
##############
#  #  #  #   #
#.$#.$# $  $ #
#  #  # #### #
#@ .  $ .  . #
#  #  ##     #
##############

