
  #######
###  #  ###
#  $.@.$  #
# # ... # #
# $ #.# $ #
##  #.#  ##
 # $ $ $ #
 #  ###  #
 #### ####

