
########
#. *. .#
# $#$$ #
#   @  #
# $$#$ #
#. .* .#
########

