
 #####
 #   ####
 #$  $  #
## @**  #
#  **. ##
# $*.. ##
###   ###
  #####

