
  #####
  #   ##
###$   ##
#  .$.$ #
# #.#.# #
#  *$*  #
###   ###
  # @ #
  #####

