
 #########
 #       #
 #$##.##$##
 # # $ .@ #
## # .##$ #
#  .   # ##
#  ##*##  #
#         #
#  #  ##  #
###########

