
   ######
   # ...#
 ### #. #
##  $$..#
#   $@*.#
# ##$$$$#
#       #
#########

