
########
#   #  #
#      ##
## ##   #
 # *..#$#
 # *..  ##
 ##$###  #
 #    $$@#
 #   ##  #
 #########

