
####
# @#####
#$$  $ ##
#.*# #  #
#  .    #
#  . #  #
#########

