
  ####
 ##  ###
 #   . ##
##.$. $ #
# $*#*$@#
#  $. *#
## .   #
 ###  ##
   ####

