
#############
#     #     #
# # $ # $ # #
# ### # ### #
# $   #   $ #
#..  *@*  ..#
#############

