
#######
#     #
# ..* #
# #$  #
# #@$ #
# *** #
#   ###
#####

