
         ####
##########  #
#   .     $ #
# #$$$#...  #
# # @ #  ####
# #$$$#...  #
#   .     $ #
#############

