
###########
# .  #  . #
# .$$$$ # #
# .  @  . #
# # $$$$. #
# .  #  . #
###########

