
###########
#    .  $ #
#  $ .$ $@#
#####.#####
# . $.$ . #
#  $ .    #
###########

