
  ######
###    ##
# $$# $.###
# . .**   #
#  $#*. . #
###@$ ## ##
  #      #
  ########

