
 #######
##  *  ##
#  *+*  #
#   #   #
#  *$*  #
##  *  ##
 #######

