
 ####
##  #
# + #####
#  * *  #
# * * * #
#  * *  #
### # $ #
  #    ##
  ######

