
   ####
  ## .######
 ##        #
 # ...###  #    ####
##   ## # ##  ###  ###
#    #  # #  ## $$   #
#   ##  # ####  @$   #
#####   #       $##  #
        #  #####    ##
        ####   ######

