
######
#   .####
# $#. $ #
#   #$$ #
#. .@. .#
# $$#   #
# $ .#$ #
####.   #
   ######

