
############
# .$ +. $. #
# #$#  #$# #
# .$.  .$. #
# #$#  #$# #
#          #
############

