
  ####
  #  ####
### * * ###
#  *   $  ###
# #  #  #   #
#+  ##### # #
# *  #  *   #
## *   ######
 #######

