
   #######
 ###  *  ###
##   #@#   ##
#  #.....#  #
# $ $$$$$ $ #
### #.#.# ###
  # #   # #
  #   #   #
  ###   ###
    #####

