
#########
#  #  . #
#. $   $##
# $###.  #
##+$     #
 #########

