
########
#  #   #
#. @ $ #
#.## $ #
#.## $ #
#.   $##
####  #
   ####

