
  #####
###   #
# $$.$#
# . . #
# # # #
# ..* ##
###@$$ #
  #    #
  ######

