
   #####
####   ##
# $ $#  ##
# $   #  #
# $#  ...#
# $  # #.#
# $  $ #.#
# #### #.#
#      #+#
##########

