
  ####
 ##  #########
 #           #
 #  ##### ## ##
### ## # .$.$ #
# $@$  #      #
# . .  ########
########

