
  ####
 #   @#
# *.$ #
# .$. #
# $.$#
 #   #
  ###

