
 ####
##  ###
#  .$ #
# .#. #
#  *$ #
# *$+###
# $.$  #
##     #
 #######

