
#########
#  +    #
#$### # #
#. . *$.#
# ### #$#
# $.    #
# # #$# #
#  .  $ #
#########

