
#########
#   ##  #
# .$  . #
## #.#$ #
##  *  ##
# $#$#  #
# .  $+ #
#  ##   #
#########

