
 #######
##  *  ##
#  *+*  #
#  ###  #
#   *   #
#  *$*  #
## # # ##
 #  *  #
 #######

