
  #####
 ##   ##
##  .  ##
# $#$.$ #
# . .$. #
# $*$*  #
##  .  ##
 ## @ ##
  #####

