
  ####
 #    #
# .*+ #
# * * #
# $*$ #
 #    #
  ####

