
 #####
 #   ###
 # # $ ####
 # $  ...+#
##### # # #
#     # # #
#  *  # # #
## #### # #
 #    $ $ #
 #  #######
 ####

