
 ####
 #  ######
 #   $@$ #
## ##*## #
#  # . # ##
#   ... $ #
##$# . #  #
#  ##*## ##
#  $      #
#  #  #   #
###########

