
    ####
  ###  #
 ## .  #
##  $  #
# .*. ##
# $ ###
# .$####
###    #
 ##$#  #
 #  #  #
 #  @ ##
 ###  #
   ####

