
###########
#@  #  #  #
#  $#$   $#
##  #..#  #
 #  #..#  #
 #  #..#  ##
 #$   $#$  #
 #  #  #   #
 ###########

