
 #########
##       ##
# .#####  #
# .     # #
# * $$  # #
# *## ##  #
# *   #  ##
# *## # ##
# +   # #
# $###  #
##     ##
 #######

