
   #####
   #   ##
   #    #
   ## * #
 ###@ *##
## .... #
#   $ # #
# $$$## #
#  #    #
#########

