
 ####
##  #####
#   #   #
#   # # ##
# $#  *  ##
# $  # #. #
#*## # #. #
#      # *#
###### #  #
    #  @  #
    #  *  #
    #######

