
#########
#   *   #
# $ * $ #
# ##.## #
#   *   #
### + ###
  #####

