
 #######
 #     #
##$#.# ##
#@$...  #
# $#.#  #
# $   $ #
#  #  ###
#######

