
  ####
  #  #
###  #
# .$.###
# $ $@ #
##.$.  #
 ##  ###
  ####

