
 ####
 #  #####   ####
 #      #   #  #
 # ###$ #####  ##
 # # #. . .   @ ##
## ####$#####    #
## #### ##  ##   #
#  #  $  #   #####
#        #
#####  ###
    ####

