
#########
#   @   #
#.$$.$$.#
#$..$..$#
#   #   #
#########

