
  #####
 #   #.#
 # $  .#
 ## ##*#
# $   .#
# # ##*#
# #$  .#
# $  #.#
# ## $ #
# @    #
 ######

