
########
#   *  #
# * .  #
# *** ##
# $ * #
## @  #
 ######

