
##########
###  $+  #
#    $. *#
# *****  #
##       #
##########

