
  #####
  # + #
### * ###
#  $*$  #
# #   # #
# #*.## #
# #   # #
#  $.$  #
### * ###
  # . #
  #####

