
 #######
 #  #  ###
##.$# .. #
# .$  $$ #
#   ## ###
######   #
# .      #
# $ @#$.##
###  #  #
  #######

