
##########
#      * #
#   #  * #
#.*****$ #
###     @#
##########

