
  #####
  #   #
###$# ###
#   #.@ #
#   *.# #
#   # # #
###$#   #
  #   ###
  #####

