
 #######
##     ##
#  *$*  #
# * # * #
#  * *  #
##  *  ##
 ## + ##
  #####

