
#####
#   ###
# *   #
##  # #
##$*  #
#+*  ##
######

