
#########
#   *   #
# $ * $ #
# ##.## #
#   *   #
### * ###
  # * #
  # + #
  #####

