
#######
#     #
#$#$$ #
# $.  ##
# .##  #
# $ #  #
#. .  +#
########

