
#########
#   #   #
#    $$@#
## ### ##
 #  .. #
##  ## #
#.**##$##
#       #
#####   #
    #####

