
####   #####
#+ #####   #
#          #
#* ##### ###
#  #.# $ #
#* #.# $ #
#  #.# $ #
#$ #.# $ #
#  #.  #$#
#    #   #
###  #####
  ####

