
###########
#    .  $ #
#  $ .$ $@#
#####.#####
#  $ .  . #
# . $.$ * #
###########

