
#### #####
#  ###   ##
# *. $  $ #
# .## #$  #
# *.*   $ #
# +########
####

