
#####
#   ####
# #@$  #
#  $*. #
####. ##
 #    #
 #   ##
 #####

