
   ######
####..  ###
#   . #   #
# $#.$  $ #
#   *### ##
####+$ $ #
   ###   #
     #####

