
  ####
 #. #.#
#. $$ .#
# $  $ #
# $ @$ #
#. $$ .#
 #.# .#
  ####

