
#########
# #   # #
# $ # . #
#@$ .*. #
# $ #   #
# #   # #
#########

