
 ####
 #  ######
 # $## @ ###
##. ##  .  #
# .    $.$ #
# *$ #$#.###
###  #   #
  ########

