
####
#  ####
#  #  ##
#.$*$. #
#      ##
# .$*$.@#
##  #   #
 ########

