
    ######
#####    ###
#    .##.  ##
# .$##   #  #
##$$ #  $   #
# .  ##$#$ ##
#  @ .  . ##
###########

