
#####
#   #####
#   #   #
## $*@  #
 # *.  ##
 #  ####
 ####

