
         ####
         #  ####
         #  $  #
#####    #   #@##
#   ## #### $  ##
# . ## #  ## #  #
##   ###    $ $ #
##     # $##  # #
 ## ......# $ $ #
 ##      ##    ##
  ##############

