
   ###
   #+#####
   #.  $ #
   #.#$# #
   #.#   #
####.## ##
#  $ $ $ #
#        #
##########

