
###########
#+ ##     #
# $       #
# # *#* # #
# #  #  # #
# #*****# #
#    #    #
###########

