
#########
#       #
# ##### #
# #   # #
# # # # ####
# #   *  + #
# ##** *## #
# $   #  # #
##### #  # #
    # #  # #
    # #### #
    #      #
    ########

