
#########
#  @#   #
# #$  . #
# $...#.#
# $$#$  #
# *     #
#########

