
########
#    * #
# $$$# #
# #.$+ #
#   ## #
#.   *.#
########

