
#######
#     #
# #   #
# $. $##
#$.##  #
# $ #  #
#.@*  .#
########

