
####### #####
#   ..###   #
#  ##.#     #
# @##$# $  ##
#      $ ###
#  #  #  #
#######  #
      ####

