
 ######
##+$  #
#.$$  #
# .*$ #
## .$ #
# $$..#
#.    #
#######

