
 #########
 #       ##
 #$##.##  #
 #@#   .  #
##$# .## ##
#  .   # #
#  ##.##$##
# $   $   #
#  #  #   #
###########

