
##########
#.      .#
# #$#$#  #
# $.  .# #
# # ## $ #
# $ ## # #
# #.  .$ #
#  #$#$# #
#.      +#
##########

