
########
#      #
# #$.@ #
#  $.###
# #$.#
#   ##
#####

