
 #####
 # @ #
## # ###
# .#$###
# *    #
# *    #
# .#$###
## # ###
 #   #
 #####

