
   ######
 ###    ######
##   ## ##   #
# $$*....*$$@#
#    ####    #
#  ###  ###  #
####      ####

