
########
#. $@ .#
# $ #$$#
# #  $ #
# *  # #
#$#. . #
#.    .#
########

