
#####
#   ###
#  @  #
##$*#.#
 #  $$#
 # .. #
 #  * #
 ######

