
 #######
 #     #
 # #*$ #
## *  ##
#  ## #
# +## #
#     #
#######

