
########
#.$@  .#
# #$##$#
#    $ #
# #$## #
#   ## #
#. .  .#
########

