
     ###
   ##   ###
  #    $$ #
 # *** .# #
#    #$$  #
#  . .+.$#
 #       #
  #######

