
  #####
  # @ #
### # ###
# $$#$$ #
# .. .  #
##  #.$##
 #   . #
 #######

