
###
#.####
#  * #
#  * #
#*$$@#
#  * #
#  * #
#.####
###

