
     #####
 #####   #
 #  # $# ##
## **  *  #
#  *.@#   #
#  ** #   #
##   ######
 #   #
 #####

