
 ####
 #  #
##  ####
#.*    #
##**   #
 #@** ##
 #  *$#
 #    #
 ######

