
#############
#   #   #   #
#   *   *   #
##$##.#+##$##
#   *   *   #
#   #   #   #
#############

