
#############
#     #   . #
# #.#$#$#$# #
# . . @   . #
# #$#$#$#.# #
#     #     #
#############

