
#############
#     #     #
# $ # $ # $ #
# ### # ### #
# $  .$.  $ #
#..  *@*  ..#
#############

