
######
#    #
# ## ##
#  .$.###
## $@$  #
 ##.$.# #
  ##  # #
   ##   #
    #####

