
  #######
  #     #
### #.# ###
#  $.*.$  #
#@$ *.* $ #
####   #  #
   ########

