
########
#. *   #
#.$#$$ #
#  .+  #
# $$#$.#
#   * .#
########

