
############
# .$  . $. #
# #$#  #$# #
# .$.+ .$. #
# #$#  #$# #
#          #
############

