
########
#.   $+#
# #$#$$#
# #  $ #
# .  # #
#$#. . #
#.    ##
########

