
##########
#      * #
#$$$# @* #
#....**$ #
###      #
##########

