
       ###
      #   #
      # # #
      # $ #
      #.#.#
      # $ #
 ###### # ######
#   .   #   .   #
# #$#$#####$#$# #
#   .   #   .   #
 ###### # ######
      # $ #
      #.#.#
      # $ #
      # # #
      # @ #
       ###

