
######
#    ###
# $$$$ #
#..# # #
#+ .. .#
#..# # #
# $$$$ #
#    ###
######

