
########
#    *@#
# #$$#$#
# #. . #
#   $# #
#.   *.#
########

