
###########
#    @    #
# ##$#$## #
# *  *  * #
# ## * ## #
#.#  *  #.#
#    *    #
###########

