
######
#    ####
# # $   #
#  *#*  #
##$.@.$##
#  *.*  #
# # # # #
#   #   #
#########

