
  #####
  #   #
  #   ##
####** ##
#   .   #
# * * * #
## #$# ##
 #  @  #
 #######

