
####   ####
#  #   #  #
# $#####$ #
#  ..  .$ #
# $. @..  #
# $#####$ #
#  #   #  #
####   ####

