
########
#      #
#  ### #
#.   # #
#.#$$$ #
#.#@ $ #
#.   ###
########

