
  ####
 #. #.#
#. $$ .#
# $  $ #
# $  $ #
#. $$ .#
 #.#@.#
  ####

