###########           
#         #           
#     #   #           
#    $##  #           
#   $@$   #           
#  $.$    #           
# #  $    #           
#  # .....#           
###########           
                      
                      
                      
                      
