####################  
#@                 #  
# $                #  
#                  #  
#                  #  
#                  #  
#                  #  
#                  #  
#                  #  
#                  #  
#                  #  
#                 .#  
####################  
