##########            
#        #            
# $    $ #            
# $    $ #            
###@######            
#.      .#            
#        #            
#.      .#            
##########            
                      
                      
                      
                      
