##########            
#        #            
#      $ #            
#      $ #            
###@######            
#.      .#            
#        #            
#        #            
##########            
                      
                      
                      
                      
