##########            
#        #            
# $  $ $ #            
# $  $ $ #            
###@######            
#.      .#            
#.      .#            
#.      .#            
##########            
                      
                      
                      
                      
