        ########      
        #     @#      
        #  #$ ##      
        # $  $#       
        ##$ $ #       
######### $ # ###     
# ...  ## $  $  #     
## ..           #     
# ...  ##########     
########              
                      
