##########            
#       @#            
# ########            
#        #            
######## #            
#        #            
##$##### #            
#.       #            
# ########            
#  $.  $.#            
#    $.$.#            
##########            
                      
