##########            
####    @#            
#   $ ## #            
#      # #            
#  ####  #            
#        #            
#######  #            
#.       #            
##########            
                      
                      
                      
                      
