#####
#   #########
# $    ##   #
##$#..      #
## ##*#### ##
#  ##. @ #  #
#  $.. # $  #
#  ###$###  #
##      #####
 ####   #
    #####